<span class="LineNumber"> 001 </span>	ภิกษุณี.  เพราะเมื่อก่อน  พวกดิฉันมิได้เห็นข้อนั้นดีด้วยปัญญาชอบตามความเป็นจริงว่า
<span class="LineNumber"> 002 </span>อายตนะภายใน  ๖  ของเรา  ไม่เที่ยง  แม้เพราะเหตุนี้  เจ้าข้า  ฯ
<span class="LineNumber"> 003 </span>	น.  ดูกรน้องหญิงทั้งหลาย  ถูกละๆ  พระอริยสาวกผู้เห็นเรื่องนี้ด้วยปัญญาชอบ  ตาม
<span class="LineNumber"> 004 </span>ความเป็นจริง  ย่อมมีความเห็นอย่างนี้แล  ฯ
<span class="LineNumber"> 005 </span>	[๗๗๐]  น.  ดูกรน้องหญิงทั้งหลาย  พวกท่านจะสำคัญความข้อนั้นเป็นไฉน  รูปเที่ยง
<span class="LineNumber"> 006 </span>หรือไม่เที่ยง  ฯ
<span class="LineNumber"> 007 </span>	ภิกษุณี.  ไม่เที่ยง  เจ้าข้า  ฯ
<span class="LineNumber"> 008 </span>	น.  ก็สิ่งใดไม่เที่ยง  สิ่งนั้นเป็นทุกข์หรือเป็นสุข  ฯ
<span class="LineNumber"> 009 </span>	ภิกษุณี.  เป็นทุกข์  เจ้าข้า  ฯ
<span class="LineNumber"> 010 </span>	น.  ก็สิ่งใดไม่เที่ยง  เป็นทุกข์  มีความแปรปรวนเป็นธรรมดา  ควรหรือที่จะตามเห็นสิ่ง
<span class="LineNumber"> 011 </span>นั้นว่า  นั่นของเรา  นั่นเรา  นั่นอัตตาของเรา  ฯ
<span class="LineNumber"> 012 </span>	ภิกษุณี.  ไม่ควรเลย  เจ้าข้า  ฯ
<span class="LineNumber"> 013 </span>	น.  ดูกรน้องหญิงทั้งหลาย  พวกท่านจะสำคัญความข้อนั้นเป็นไฉน  เสียงเที่ยงหรือ
<span class="LineNumber"> 014 </span>ไม่เที่ยง  ฯ
<span class="LineNumber"> 015 </span>	ภิกษุณี.  ไม่เที่ยง  เจ้าข้า  ฯลฯ
<span class="LineNumber"> 016 </span>	น.  กลิ่นเที่ยงหรือไม่เที่ยง  ฯ
<span class="LineNumber"> 017 </span>	ภิกษุณี.  ไม่เที่ยง  เจ้าข้า  ฯลฯ
<span class="LineNumber"> 018 </span>	น.  รสเที่ยงหรือไม่เที่ยง  ฯ
<span class="LineNumber"> 019 </span>	ภิกษุณี.  ไม่เที่ยง  เจ้าข้า  ฯลฯ
<span class="LineNumber"> 020 </span>	น.  โผฏฐัพพะเที่ยงหรือไม่เที่ยง  ฯ
<span class="LineNumber"> 021 </span>	ภิกษุณี.  ไม่เที่ยง  เจ้าข้า  ฯ
<span class="LineNumber"> 022 </span>	น.  ธรรมารมณ์เที่ยงหรือไม่เที่ยง  ฯ
<span class="LineNumber"> 023 </span>	ภิกษุณี.  ไม่เที่ยง  เจ้าข้า  ฯ
<span class="LineNumber"> 024 </span>	น.  ก็สิ่งใดไม่เที่ยง  สิ่งนั้นเป็นทุกข์หรือเป็นสุข  ฯ
<span class="LineNumber"> 025 </span>	ภิกษุณี.  เป็นทุกข์  เจ้าข้า  ฯ
