<span class="LineNumber"> 001 </span>		 วณฺโณ จ เม สพฺพทิสา ปภาสตีติ ฯ   
<span class="LineNumber"> 002 </span>		  โสณทินฺนาวิมานํ ฉฏฺํ ฯ   
<span class="LineNumber"> 003 </span>	[๒๔] ๗ อภิกฺกนฺเตน วณฺเณน       ยา ตฺวํ ติฏฺสิ เทวเต  
<span class="LineNumber"> 004 </span>	  โอภาเสนฺตี ทิสา สพฺพา    โอสธี วิย ตารกา  
<span class="LineNumber"> 005 </span>	  เกน เตตาทิโส วณฺโณ     ... เป ...   
<span class="LineNumber"> 006 </span>		 วณฺโณ จ เต สพฺพทิสา ปภาสตีติ ฯ   
<span class="LineNumber"> 007 </span>	  สา เทวตา อตฺตมนา      โมคฺคลฺลาเนน ปุจฺฉิตา   
<span class="LineNumber"> 008 </span>	  ... เป ...           ยสฺส กมฺมสฺสิทํ ผลํ  
<span class="LineNumber"> 009 </span>	  อุโปสถาติ มํ อฺึสุ       สาเกตายํ อุปาสิกา  
<span class="LineNumber"> 010 </span>	  สทฺธาสีเลน สมฺปนฺนา      สํวิภาครตา สทา   
<span class="LineNumber"> 011 </span>	  อจฺฉาทนฺจ ภตฺตฺจ       เสนาสนํ ปทีปิยํ  
<span class="LineNumber"> 012 </span>	  อทาสึ อุชุภูเตสุ          วิปฺปสนฺเนน เจตสา   
<span class="LineNumber"> 013 </span>	  จาตุทฺทสึ ปฺจทสึ         ยา จ ปกฺขสฺส อฏฺมี   
<span class="LineNumber"> 014 </span>	  ปาฏิหาริยปกฺขฺจ         อฏฺงฺคสุสมาคตํ  
<span class="LineNumber"> 015 </span>	  อุโปสถํ อุปวสึ           สทา สีเล สุสํวุตา  
<span class="LineNumber"> 016 </span>	  ปาณาติปาตา วิรตา       มุสาวาทา จ สฺตา  
<span class="LineNumber"> 017 </span>	  เถยฺยา จ อติจารา จ     มชฺชปานา จ อารกา   
<span class="LineNumber"> 018 </span>	  ปฺจสิกฺขาปเท รตา       อริยสจฺจาน โกวิทา   
<span class="LineNumber"> 019 </span>	  อุปาสิกา จกฺขุมโต        โคตมสฺส ยสสฺสิโน   
<span class="LineNumber"> 020 </span>	  เตน เมตาทิโส วณฺโณ     ... เป ...   
