<span class="LineNumber"> 001 </span>	  อภิกฺกนฺเตน วณฺเณน        ยา ตฺวํ ติฏฺสิ เทวเต   
<span class="LineNumber"> 002 </span>	  โอภาเสนฺตี ทิสา สพฺพา     โอสธี วิย ตารกา   
<span class="LineNumber"> 003 </span>	  เกน เตตาทิโส วณฺโณ      เกน เต อิธมิชฺฌติ   
<span class="LineNumber"> 004 </span>	  อุปฺปชฺชนฺติ จ เต โภคา     เย เกจิ มนโส ปิยา  
<span class="LineNumber"> 005 </span>		 ปุจฺฉามิ ตํ เทวิ มหานุภาเว   
<span class="LineNumber"> 006 </span>		 มนุสฺสภูตา กิมกาสิ ปุฺํ  
<span class="LineNumber"> 007 </span>		 เกนาปิ ๑ เอวํ ชลิตานุภาวา   
<span class="LineNumber"> 008 </span>		 วณฺโณ จ เต สพฺพทิสา ปภาสตีติ ฯ   
<span class="LineNumber"> 009 </span>	  สารีปุตฺตสฺสาหํ มาตา       ปุพฺเพ อฺาสุ ชาตีสุ  
<span class="LineNumber"> 010 </span>	  อุปฺปนฺนา ปิตฺติวิสยํ         ขุปฺปิปาสา สมปฺปิตา   
<span class="LineNumber"> 011 </span>	  ฉฑฺฑิตํ ขิปิตํ เขฬํ          สิงฺฆาณิกํ กิเลสุมํ  
<span class="LineNumber"> 012 </span>	  วสฺจ ฑยฺหมานานํ         วิชาตานฺจ โลหิตํ  
<span class="LineNumber"> 013 </span>	  วณิตานฺจ ยํ ฆานํ         สีสจฺฉินฺนฺจ โลหิตํ  
<span class="LineNumber"> 014 </span>	  ขุทาปเรตา ภุฺชิสฺสํ ๒     อิตฺถีปุริสนิสฺสิตํ   
<span class="LineNumber"> 015 </span>	  ปุพฺพโลหิตํ ภกฺขิสฺสํ         ปสูนํ มนุสฺสานฺจ   
<span class="LineNumber"> 016 </span>	  อเลณา จ อนคารา จ      นีลมฺจปรายนา ฯ   
<span class="LineNumber"> 017 </span>	  สารีปุตฺตสฺส ทาเนน        โมทามิ อกุโตภยา   
<span class="LineNumber"> 018 </span>	  มุนึ การุณิกํ โลเก         ตํ ๓ ภนฺเต วนฺทิตุมาคตาติ ฯ   
<span class="LineNumber"> 019 </span>	      สารีปุตฺตตฺเถรสฺส มาตุเปติวตฺถุ ทุติยํ ฯ  
<span class="LineNumber"> 020 </span>[๑๐๐] ๓ นคฺคา ทุพฺพณฺณรูปาสิ กีสา ธมนิสณฺิตา  
<span class="LineNumber"> 021 </span>#๑ ม. เกนาสิ ฯ  ๒ ม. ภุฺชามิ ฯ  ๓ ม. อยํ ปาโ นตฺถิ ฯ  
