<span class="LineNumber"> 001 </span>	  ตสฺส กมฺมสฺส กุสลสฺส       อนุโภมิ รตฺตึ อมานุสึ  
<span class="LineNumber"> 002 </span>	  ทิวา ปฏิหตาว กุกฺกุรา      อุปธาวนฺติ สมนฺตา ขาทิตุํ   
<span class="LineNumber"> 003 </span>	  เย จ เต สตตานุโยคิโน    ธุวํ ปยุตฺตา สุคตสฺส สาสเน  
<span class="LineNumber"> 004 </span>	  มฺามิ เต อมตเมว       เกวลํ อธิคจฺฉนฺติ   
<span class="LineNumber"> 005 </span>			      ปทํ อสงฺขตนฺติ ฯ  
<span class="LineNumber"> 006 </span>		 ทุติยมิคลุทฺทเปตวตฺถุ อฏฺมํ ฯ   
<span class="LineNumber"> 007 </span> [๑๑๙] ๙ มาลี กิรีฏี ๑ กายูรี       คตฺตา เต จนฺทนุสฺสทา  
<span class="LineNumber"> 008 </span>	  ปสนฺนมุขวณฺโณสิ           สุริยวณฺโณว โสภสิ ฯ   
<span class="LineNumber"> 009 </span>	  อมานุสา ปริสชฺชา         เย เต เม ปริวาริกา   
<span class="LineNumber"> 010 </span>	  ทส กฺาสหสฺสานิ         ยา เตมา ปริจาริกา ฯ  
<span class="LineNumber"> 011 </span>	  ตา กมฺพุกายูรธรา         กฺจนเจลภูสิตา   
<span class="LineNumber"> 012 </span>	  มหานุภาโวสิ ตุวํ          โลมหํสนรูปวา ฯ  
<span class="LineNumber"> 013 </span>	  ปิฏฺิมํสานิ อตฺตโน         สามํ อุกฺกจฺจ ๒ ขาทสิ  
<span class="LineNumber"> 014 </span>	  กินฺนุ กาเยน วาจาย       มนสา ทุกฺกฏํ กตํ   
<span class="LineNumber"> 015 </span>	  กิสฺส กมฺมวิปาเกน         ปิฏฺิมํสานิ อตฺตโน   
<span class="LineNumber"> 016 </span>			      สามํ อุกฺกจฺจ ๒ ขาทสิ ฯ  
<span class="LineNumber"> 017 </span>	  อตฺตโนหํ อนตฺถาย         ชีวโลเก อจริสฺสํ   
<span class="LineNumber"> 018 </span>	  เปสุฺมุสาวาเทน         นิกติวฺจนาย จ ฯ   
<span class="LineNumber"> 019 </span>	  ตตฺถาหํ ปริสํ คนฺตฺวา       สจฺจกาเล อุปฏฺิเต  
<span class="LineNumber"> 020 </span>#๑ ม. กิริฏี ฯ  ๒ ยุ. อุกฺกนฺตฺวา ฯ   
