<span class="LineNumber"> 001 </span>	  ททฺทลฺลมานา อาเภนฺติ      สมนฺตา จตุโร ทิสา ฯ   
<span class="LineNumber"> 002 </span>	  ตถา ภนฺเต ปรกฺกม        ยถา ปานํ ลภามเส ฯ   
<span class="LineNumber"> 003 </span>	  เถโร กรกํ ๑ ปูเรตฺวา    สงฺเฆ จาตุทฺทิเส อทา ฯ   
<span class="LineNumber"> 004 </span>	  ทตฺวา อนฺวาทิสิ เถโร      ปิตุ มาตุ จ ภาตุโน  
<span class="LineNumber"> 005 </span>	  อิทํ เม าตีนํ โหตุ        สุขิตา โหนฺตุ าตโย ฯ  
<span class="LineNumber"> 006 </span>	  สมนนฺตรานุทิฏฺเ          ปานียํ อุปปชฺชถ ๒  
<span class="LineNumber"> 007 </span>	  คมฺภีรา จตุรสฺสา จ        โปกฺขรฺา ๓ สุนิมฺมิตา  
<span class="LineNumber"> 008 </span>	  สีตุทกา สุปติตฺถา จ        สีตา อปฺปฏิคนฺธิยา   
<span class="LineNumber"> 009 </span>	  ปทุมุปฺปลสฺฉนฺนา          วาริกิฺชกฺขปูริตา ฯ   
<span class="LineNumber"> 010 </span>	  ตตฺถ นหาตฺวา ปิวิตฺวา      เถรสฺส ปฏิทสฺสยุํ   
<span class="LineNumber"> 011 </span>	  ปหูตํ ปานียํ ภนฺเต         ปาปา ๔ ทุกฺขผลนฺติ โน   
<span class="LineNumber"> 012 </span>	  อาหิณฺฑมานา ขฺชาม       สกฺขเร กุสกณฺฏเก   
<span class="LineNumber"> 013 </span>	  ตถา ภนฺเต ปรกฺกม        ยถา ยานํ ลภามเส ฯ   
<span class="LineNumber"> 014 </span>	  เถโร สิปาฏิกํ ลทฺธา       สงฺเฆ จาตุทฺทิเส อทา ฯ  
<span class="LineNumber"> 015 </span>	  ทตฺวา อนฺวาทิสิ เถโร      ปิตุ มาตุ จ ภาตุโน  
<span class="LineNumber"> 016 </span>	  อิทํ เม าตีนํ โหตุ        สุขิตา โหนฺตุ าตโย ฯ  
<span class="LineNumber"> 017 </span>	  สมนนฺตรานุทิฏฺเ          เปตา รเถน มาคมม   
<span class="LineNumber"> 018 </span>	  อนุกมฺปิตมฺห ภทนฺเต        ภตฺเตน ฉาทเนน จ  
<span class="LineNumber"> 019 </span>	  ฆเรน ปานียทาเนน        ยานทาเนน จูภยํ   
<span class="LineNumber"> 020 </span>	  มุนึ การุณิกํ โลเก         ตํ ๕ ภนฺเต วนฺทิตุมาคตาติ ฯ   
<span class="LineNumber"> 021 </span>	       สานุวาสิตฺเถรเปตวตฺถุ ๖ ทุติยํ ฯ  
<span class="LineNumber"> 022 </span>#๑ ม. กรณํ ฯ  ๒ ม. อุทปชฺชถ ฯ  ๓ โปกฺขรฺโ ฯ  ๔ ม. ปาทา ทุกฺขา ฯ   
<span class="LineNumber"> 023 </span>#๕ ม. อยํ ปาโ นตฺถิ ฯ  ๖ ม. สาณวาสีเถรเปตวตฺถุ ฯ   
