<span class="LineNumber"> 001 </span>	  สพฺเพสํ นาคนามานํ        สจฺจนาโม อนุตฺตโร  
<span class="LineNumber"> 002 </span>	  นาคํ โว กิตฺตยิสฺสามิ       น หิ อาคุํ กโรติ โส ฯ  
<span class="LineNumber"> 003 </span>	  โสรจฺจํ อวิหึสา จ         ปาทา นาคสฺส เต ทุเว ฯ   
<span class="LineNumber"> 004 </span>	  สติ จ สมฺปชฺฺจ         จรณา นาคสฺส เต ๑ ปเร ฯ   
<span class="LineNumber"> 005 </span>	  สทฺธาหตฺโถ มหานาโค      อุเปกฺขาเสตทนฺตวา ฯ   
<span class="LineNumber"> 006 </span>	  สติ คีวา สิโร ปฺา       วีมํสา ธมฺมจินฺตนา  
<span class="LineNumber"> 007 </span>	  ธมฺมกุจฺฉิสมาวาโส ๒      วิเวโก ตสฺส วาลธิ ฯ   
<span class="LineNumber"> 008 </span>	  โส ฌายี อสฺสาสรโต       อชฺฌตฺตํ สุสมาหิโต  
<span class="LineNumber"> 009 </span>	  คจฺฉํ สมาหิโต นาโค       ิโต นาโค สมาหิโต  
<span class="LineNumber"> 010 </span>	  สยํ สมาหิโต นาโค        นิสินฺโนปิ สมาหิโต  
<span class="LineNumber"> 011 </span>	  สพฺพตฺถ สํวุโต นาโค       เอสา นาคสฺส สมฺปทา ฯ  
<span class="LineNumber"> 012 </span>	  ภุฺชติ อนวชฺชานิ          สาวชฺชานิ น ภุฺชติ  
<span class="LineNumber"> 013 </span>	  ฆาสํ อจฺฉาทนํ ลทฺธา       สนฺนิธึ ปริวชฺชยํ   
<span class="LineNumber"> 014 </span>	  สํโยชนํ อณณ ถูลํ           สพฺพํ เฉตฺวาน พนฺธนํ   
<span class="LineNumber"> 015 </span>	  เยน เยเนว คจฺฉติ        อนเปกฺโขว คจฺฉติ ฯ  
<span class="LineNumber"> 016 </span>	  ยถาปิ อุทเก ชาตํ         ปุณฺฑรีกํ ปวฑฺฒติ  
<span class="LineNumber"> 017 </span>	  โนปลิปฺปติ โตเยน         สุจิคนฺธํ มโนรมํ   
<span class="LineNumber"> 018 </span>	  ตเถว จ โลเก ชาโต      พุทฺโธ โลเก วิหรติ  
<span class="LineNumber"> 019 </span>	  โนปลิปฺปติ โลเกน         โตเยน ปทุมํ ยถา ฯ  
<span class="LineNumber"> 020 </span>	  มหาคฺคินิ ๓ ปชฺชลิโต      อนาหาโรปสมฺมติ   
<span class="LineNumber"> 021 </span>#๑ ตฺยาปเรติปิ ฯ   ๒ ธมฺมกุจฺฉิสมาตโปติปิ ฯ   ๓ ยุ. มหาคินิ ฯ   
