<span class="LineNumber"> 001 </span>	  อชฺฌตฺตฺจ พหิทฺธา จ       เย เม วิชฺชึสุ อาสวา   
<span class="LineNumber"> 002 </span>	  สพฺเพ อเสสา อุจฺฉินฺนา     น จ อุปฺปชฺชเร ปุน ฯ   
<span class="LineNumber"> 003 </span>	  วิสารทา โข ภคินี         เอตมตฺถํ อภาสยิ  
<span class="LineNumber"> 004 </span>	  อปิ หา นูน มยิปิ          วนโถ เต น วิชฺชติ ฯ   
<span class="LineNumber"> 005 </span>	  ปริยนฺตกตํ ทุกฺขํ           อนฺติโมยํ สมุสฺสโย  
<span class="LineNumber"> 006 </span>	  ชาติมรณสํสาโร           นตฺถิทานิ ปุนพฺภโวติ ฯฏ   
<span class="LineNumber"> 007 </span>		    วฑฺโฒ เถโร ฯ  
<span class="LineNumber"> 008 </span> [๓๔๐] ๖ อตฺถาย วต เม พุทฺโธ      นทึ เนรฺชรํ อคา   
<span class="LineNumber"> 009 </span>	  ยสฺสาหํ ธมฺมํ สุตฺวาน       มิจฺฉาทิฏฺึ วิวชฺชยึ ฯ   
<span class="LineNumber"> 010 </span>	  ยชึ  อุจฺจาวเจ ยฺเ      อคฺคิหุตํ ชุหึ อหํ  
<span class="LineNumber"> 011 </span>	  เอสา สุทฺธีติ มฺนฺโต      อนฺธภูโต ปุถุชฺชโน ฯ  
<span class="LineNumber"> 012 </span>	  ทิฏฺิคหณปกฺขนฺโน          ปรามาเสน โมหิโต  
<span class="LineNumber"> 013 </span>	  อสุทฺธึ มฺิสํ สุทฺธึ         อนฺธภูโต อวิทฺทสุ ฯ  
<span class="LineNumber"> 014 </span>	  มิจฺฉาทิฏฺิ ปหีนา เม       ภวา สพฺเพ ปทาลิตา ๑  
<span class="LineNumber"> 015 </span>	  ชุหามิ ทกฺขิเณยฺยคฺคึ        นมสฺสามิ ตถาคตํ ฯ  
<span class="LineNumber"> 016 </span>	  โมหา สพฺเพ ปหีนา เม     ภวตณฺหา ปทาลิตา   
<span class="LineNumber"> 017 </span>	  วิกฺขีโณ ชาติสํสาโร        นตฺถิทานิ ปุนพฺภโวติ ฯ   
<span class="LineNumber"> 018 </span>		     นทีกสฺสโป เถโร ฯ   
<span class="LineNumber"> 019 </span> [๓๔๑] ๗ ปาโต มชฺฌนฺติกํ สายํ       ติกฺขตฺตุํ ทิวสสฺสหํ  
<span class="LineNumber"> 020 </span>	  โอตรึ อุทกํ โสหํ ๒       คยาย คยผคฺคุยา ฯ  
<span class="LineNumber"> 021 </span>#๑ ม. ยุ. วิทาลิตา ฯ  ๒ ยุ. โสตํ ฯ  
