<span class="LineNumber"> 001 </span>	  ปุฺํปิมา วเหยฺยุํ เต ๑    เตน ตฺวํ ปริพาหิโร อสฺส ๒ ฯ  
<span class="LineNumber"> 002 </span>	  ยสฺส พฺราหฺมณ ตฺวํ ภีโต     สทา อุทกโมตริ   
<span class="LineNumber"> 003 </span>	  ตเมว พฺรเหฺม มากาสิ      มา เต สีตํ ฉวึ หเน ฯ   
<span class="LineNumber"> 004 </span>	  กุมคฺคปฏิปนฺนํ มํ           อริยมคฺคํ สมานยิ  
<span class="LineNumber"> 005 </span>	  อุทกาภิเสจนํ ๓ โภติ      อิมํ สาฏกํ ททามิ เต ฯ   
<span class="LineNumber"> 006 </span>	  ตุเยฺหว สาฏโก โหตุ       นาหมิจฺฉามิ สาฏกํ ฯ  
<span class="LineNumber"> 007 </span>	  สเจ ภายสิ ทุกฺขสฺส        สเจ เต ทุกฺขมปฺปิยํ   
<span class="LineNumber"> 008 </span>	  มากาสิ ปาปกํ กมฺมํ        อาวิ วา ยทิ วา รโห ฯ  
<span class="LineNumber"> 009 </span>	  สเจ จ ปาปกํ กมฺมํ        กริสฺสสิ กโรสิ วา  
<span class="LineNumber"> 010 </span>	  น เต ทุกฺขา ปมุตฺยตฺถิ      อุเปจฺจาปิ ปลายโต ฯ   
<span class="LineNumber"> 011 </span>	  สเจ ภายสิ ทุกฺขสฺส        สเจ เต ทุกฺขมปฺปิยํ   
<span class="LineNumber"> 012 </span>	  อุเปหิ พุทฺธํ สรณํ          ธมฺมํ สงฺฆฺจ ตาทินํ  
<span class="LineNumber"> 013 </span>	  สมาทิยาหิ สีลานิ          ตนฺเต โมกฺขาย ๔ เหสฺสติ ฯ  
<span class="LineNumber"> 014 </span>	  พฺรหฺมพนฺธุ ปุเร อาสึ       อชฺชมฺหิ สจฺจ พฺราหฺมโณ   
<span class="LineNumber"> 015 </span>	  เตวิชฺโช เวทสมฺปนฺโน      โสตฺถิโย จมฺหิ นฺหาตโก ฯ  
<span class="LineNumber"> 016 </span>		    ปุณฺณิกา ๕ ฯ   
<span class="LineNumber"> 017 </span>		โสฬสกนิปาโต สมตฺโต ฯ  
<span class="LineNumber"> 018 </span>		_______________________  
<span class="LineNumber"> 019 </span>#๑ ยุ. อยํ ปาโ นตฺถิ ฯ ๒ ม. อยํ ปาโ นตฺถิ ฯ ๓ ม. ทกาภิเสจนา ฯ   
<span class="LineNumber"> 020 </span>#๔ ม. ยุ. อตฺถาย เหหิติ ฯ ๕ ม. ปุณฺณา ฯ   
