<span class="LineNumber"> 001 </span>		 เถรีคาถาย จตฺตาฬีสนิปาโต   
<span class="LineNumber"> 002 </span> [๔๗๓] ๑ นครมฺหิ กุสุมนาเม         ปาฏลิปุตฺตมฺหิ ปวิยา   
<span class="LineNumber"> 003 </span>	  มณฺเฑ สกฺยกุลกุลีนาโย      เทฺว ภิกฺขุนิโย คุณวติโย ฯ   
<span class="LineNumber"> 004 </span>	  อิสิทาสี ตตฺถ เอกา        ทุติยา โพธีติ สีลสมฺปนฺนา จ   
<span class="LineNumber"> 005 </span>	  ฌานชฺฌายนรตาโย         พหุสฺสุตาโย ธุตกิเลสาโย ฯ  
<span class="LineNumber"> 006 </span>	  ตา ปิณฺฑาย จริตฺวาน ๑    ภตฺตตฺถํ  กริย โธตาปตฺตาโย  
<span class="LineNumber"> 007 </span>	  รหิตมฺหิ สุขนิสินฺนา         อิมา คิรา อพฺภวเทสุํ ๒ ฯ   
<span class="LineNumber"> 008 </span>	  ปาสาทิกาสิ อยฺเย อิสิทาสิ   วโยปิ เต อปริหีโน   
<span class="LineNumber"> 009 </span>	  กึ ทิสฺวาน วลิกํ ๓ อถาสิ   เนกฺขมฺมมนุยุตฺตา ฯ   
<span class="LineNumber"> 010 </span>	  เอวมนุยุฺชิยมานา สา      รหิเต ธมฺมเทสนากุสลา  
<span class="LineNumber"> 011 </span>	  อิสิทาสี อิทํ วจนมพฺรวิ ๔   สุณ โพธิ ยถามฺหิ ปพฺพชิตา ฯ  
<span class="LineNumber"> 012 </span>		อิโต ปรํ วิสชฺชนกถา ๕  
<span class="LineNumber"> 013 </span>	  อุชฺเชนิยา ปุรวเร มยฺหํ     ปิตา สีลสํวุโต เสฏฺี   
<span class="LineNumber"> 014 </span>	  ตสฺสมฺหิ เอกา ธีตา ๖     ปิยา มนาปา ทยิตา จ ฯ  
<span class="LineNumber"> 015 </span>	  อถ เม สาเกตโต วรโก    อาคจฺฉิ อุตฺตมกุลีโน  
<span class="LineNumber"> 016 </span>	  เสฏฺี ปหูตรตโน ตสฺส      มํ สุณฺหํ อทาสิ ตาโต ฯ  
<span class="LineNumber"> 017 </span>	  สสฺสุยา สสฺสุรสฺส จ        สายํ ปาตํ ปณามมุปคมฺม  
<span class="LineNumber"> 018 </span>	  สิรสา กโรมิ ปาเท        วนฺทามิ ยถามฺหิ อนุสิฏฺา ฯ   
<span class="LineNumber"> 019 </span>#๑ ม. ยุ. จริตฺวา ฯ ๒ ม. ยุ. อพฺภุทีเรสุํ ฯ ๓ ม. พฺยาลิกํ ฯ ๔ โป. ม. อิสิทาสี  
<span class="LineNumber"> 020 </span>#วจนมพฺรวิ ฯ ๕ ยุ. อิทํ ปาตฺตยํ น ทิสฺสติ ฯ ๖ ม. เอกธีตา ฯf  
