<span class="LineNumber"> 001 </span>	ตเถวาหํ มหาวีร          ยถาปิ ครุโฬ พลี  
<span class="LineNumber"> 002 </span>	อสงฺขตํ คเวสนฺโต         โทเส วิกฺขาลยึ อหํ ฯ  
<span class="LineNumber"> 003 </span>	ทิฏฺโ อหํ ธมฺมวรํ         สนฺติปทํ อนุตฺตรํ  
<span class="LineNumber"> 004 </span>	อาทาย วิหราเมตํ         ครุโฬ ปนฺนคํ ยถา ฯ  
<span class="LineNumber"> 005 </span>	อาสาวตี นาม ลตา        ชาตา จิตฺตลตาวเน  
<span class="LineNumber"> 006 </span>	ตสฺสา วสฺสสหสฺเสน        เอกํ นิพฺพตฺตเต ผลํ ฯ  
<span class="LineNumber"> 007 </span>	ตํ เทวา ปยิรุปาสนฺติ       ตาว ทูรผลํ ๑ สกึ  
<span class="LineNumber"> 008 </span>	เทวานํ สา ปิยา เอวํ      อาสาวตี ผลุตฺตมา ๒ ฯ  
<span class="LineNumber"> 009 </span>	สตสหสฺสํ อุปาทาย         ตาหํ ปริจเร มุนึ ๓  
<span class="LineNumber"> 010 </span>	สายํ ปาตํ นมสฺสามิ        เทวา อาสาวตึ ยถา ฯ  
<span class="LineNumber"> 011 </span>	อวฺฌา ปาริจริยา         อโมฆา จ นมสฺสนา  
<span class="LineNumber"> 012 </span>	ทูราคตํปิ มํ สนฺตํ          ขโณ มํ ๔ น วิราธยิ ฯ  
<span class="LineNumber"> 013 </span>	ปฏิสนฺธึ น ปสฺสามิ         วิจินนฺโต ภเว อหํ  
<span class="LineNumber"> 014 </span>	นิรูปธิ วิปฺปมุตฺโต          อุปสนฺโต จรามหํ ฯ  
<span class="LineNumber"> 015 </span>	ยถาปิ ปทุมํ นาม          สุริยรํเสน ปุปฺผติ  
<span class="LineNumber"> 016 </span>	ตเถวาหํ มหาวีร          พุทฺธรํเสน ปุปฺผิโต ฯ  
<span class="LineNumber"> 017 </span>	ยถา พลากโยนิมฺหิ         น วิชฺชติ ปุมา ๔ สทา  
<span class="LineNumber"> 018 </span>	เมเฆสุ คชฺชมาเนสุ        คพฺภํ คณฺหนฺติ ตา สทา ฯ  
<span class="LineNumber"> 019 </span>	จิรํปิ คพฺภํ ธาเรนฺติ        ยาว เมโฆ น คชฺชติ  
<span class="LineNumber"> 020 </span>	ภารโต ปริมุจฺจนฺติ         ยทา เมโฆ ปวสฺสติ ฯ  
<span class="LineNumber"> 021 </span>#๑ ม. ตาว ทูรผเล สติ ฯ ๒ ม. ยุ. ลตุตฺตมา ฯ ๓ ม. มุนิ ฯ ๔ ม. ยํ ฯ  
<span class="LineNumber"> 022 </span>#๕ โป. ม. ปุโม ฯ  
