<span class="LineNumber"> 001 </span>	นิสีทิ ตตฺถ ภควา          อสมฺภีโตว เกสรี  
<span class="LineNumber"> 002 </span>	สตฺตรตฺตินฺทิวํ พุทฺโธ        ปวเร กุสุมาสเน ฯ  
<span class="LineNumber"> 003 </span>	นมสฺสมาโน อฏฺาสึ        สตฺตรตฺตินฺทิวํ อหํ  
<span class="LineNumber"> 004 </span>	วุฏฺหิตฺวา สมาธิมฺหา       สตฺถา โลเก อนุตฺตโร ฯ  
<span class="LineNumber"> 005 </span>	มม กมฺมํ ปกิตฺเตนฺโต       อิทํ วจนมพฺรวิ  
<span class="LineNumber"> 006 </span>	ภาเวหิ พุทฺธานุสฺสตึ        ภาวนานํ อนุตฺตรํ ฯ  
<span class="LineNumber"> 007 </span>	อิมํ สตึ ภาวยิตฺวา         ปูรยิสฺสสิ มานสํ  
<span class="LineNumber"> 008 </span>	ตึสกปฺปสหสฺสานิ           เทวโลเก รมิสฺสสิ ฯ  
<span class="LineNumber"> 009 </span>	อสีติกฺขตฺตุํ เทวินฺโท        เทวรชฺชํ กริสฺสสิ  
<span class="LineNumber"> 010 </span>	สหสฺสกฺขตฺตุํ จกฺกวตฺติ       ราชา รฏฺเ ภวิสฺสสิ ฯ  
<span class="LineNumber"> 011 </span>	ปเทสรชฺชํ วิปุลํ           คณนาโต อสงฺขยํ  
<span class="LineNumber"> 012 </span>	อนุโภสฺสสิ ตํ สพฺพํ         พุทฺธานุสฺสติยา ผลํ ฯ  
<span class="LineNumber"> 013 </span>	ภวาภเว สํสรนฺโต         มหาโภคํ ลภิสฺสสิ  
<span class="LineNumber"> 014 </span>	โภเคหิ ๑ โอนตา นตฺถิ    พุทฺธานุสฺสติยา ผลํ ฯ  
<span class="LineNumber"> 015 </span>	กปฺปสตสหสฺสมฺหิ           โอกฺกากกุลสมฺภโว  
<span class="LineNumber"> 016 </span>	โคตโม นาม โคตฺเตน      สตฺถา โลเก ภวิสฺสติ ฯ  
<span class="LineNumber"> 017 </span>	อสีติโกฏึ ฉฑฺเฑตฺวา        ทาสกมฺมกเร พหู  
<span class="LineNumber"> 018 </span>	โคตมสฺส ภควโต          สาสเน ปพฺพชิสฺสสิ ฯ  
<span class="LineNumber"> 019 </span>	อาราธยิตฺวาน สมฺพุทฺธํ      โคตมํ สากฺยปุงฺควํ  
<span class="LineNumber"> 020 </span>	สุภูติ นาม นาเมน         เหสฺสสิ ๒ สตฺถุสาวโก ฯ  
<span class="LineNumber"> 021 </span>#๑ ม. ยุ. โภเค เต อูนตา นตฺถิ ฯ ๒ โป. ม. เหสฺสติ ฯ  
