<span class="LineNumber"> 001 </span>	อหํปิ หิมวนฺตมฺหิ           วสามิ อสฺสเม ตทา  
<span class="LineNumber"> 002 </span>	อจิราคตํ มหาวีรํ          อุเปสึ โลกนายกํ ฯ  
<span class="LineNumber"> 003 </span>	ปุปฺผจฺฉตฺตํ คเหตฺวาน       อุปคฺฉึ นราสภํ  
<span class="LineNumber"> 004 </span>	สมาธึ สมาปชฺชนฺตํ         อนฺตรายมกาสหํ ฯ  
<span class="LineNumber"> 005 </span>	อุโภหตฺเถหิ ปคฺคยฺห        ปุปฺผจฺฉตฺตํ อทาสหํ  
<span class="LineNumber"> 006 </span>	ปฏิคฺคเหสิ ภควา          ปทุมุตฺตโร มหามุนิ ฯ  
<span class="LineNumber"> 007 </span>	สพฺเพ เทวา อตฺตมนา      หิมวนฺตํ อุเปนฺติ เต  
<span class="LineNumber"> 008 </span>	สาธุการํ ปวตฺตึสุ          อนุโมทิสฺสติ จกฺขุมา ฯ  
<span class="LineNumber"> 009 </span>	อิทํ วตฺวาน เต เทวา      อุปคฺฉฉ นรุตฺตมํ  
<span class="LineNumber"> 010 </span>	อากาเส ธารยนฺตสฺส       ปทุมํ ฉตฺตมุตฺตมํ ฯ  
<span class="LineNumber"> 011 </span>	สตฺตปตฺตฉตฺตํ ๑ ปคฺคยฺห    อทาสิ ตาปโส มม  
<span class="LineNumber"> 012 </span>	ตมหํ กิตฺตยิสฺสามิ          สุณาถ มม ภาสโต ฯ  
<span class="LineNumber"> 013 </span>	ปฺจวีสติกปฺปานิ           เทวรชฺชํ กริสฺสติ  
<span class="LineNumber"> 014 </span>	จตุตฺตึสติกฺขตฺตุฺจ          จกฺกวตฺติ ภวิสฺสติ ฯ  
<span class="LineNumber"> 015 </span>	ยํ ยํ โยนึ สํสรติ          เทวตฺตํ อถ มานุสํ  
<span class="LineNumber"> 016 </span>	อพฺโภกาเส ปติฏฺนฺตํ       ปทุมํ ธารยิสฺสติ ฯ  
<span class="LineNumber"> 017 </span>	กปฺปสตสหสฺสมฺหิ           โอกฺกากกุลสมฺภโว  
<span class="LineNumber"> 018 </span>	โคตโม นาม โคตฺเตน      สตฺถา โลเก ภวิสฺสติ ฯ  
<span class="LineNumber"> 019 </span>	ปกาสิเต ปาวจเน         มนุสฺสตฺตํ ลภิสฺสติ  
<span class="LineNumber"> 020 </span>	มโนมยมฺหิ กายมฺหิ         อุตฺตโม โส ภวิสฺสติ ฯ  
<span class="LineNumber"> 021 </span>#๑ ยุ. ปทุมฉตฺตํ ฯ  
