<span class="LineNumber"> 001 </span>	อชฺโฌคเหตฺวา หิมวนฺตํ      อคฺโค การุณิโก มุนิ  
<span class="LineNumber"> 002 </span>	ปลฺลงฺกํ อาภุชิตฺวาน        นิสีทิ ปุริสุตฺตโม ฯ  
<span class="LineNumber"> 003 </span>	ตมทฺทสาหํ สมฺพุทฺธํ         สปฺปภาสํ มโนรมํ  
<span class="LineNumber"> 004 </span>	อินฺทีวรํว ชลิตํ            อาทิตฺตํว หุตาสนํ ฯ  
<span class="LineNumber"> 005 </span>	ชลนฺตํ ทีปรุกฺขํว           วิชฺชชว ๑ คคเณ ยถา  
<span class="LineNumber"> 006 </span>	สุผุลฺลํ สาลราชํว          อทฺทสํ โลกนายกํ ฯ  
<span class="LineNumber"> 007 </span>	อยํ นาโค มหาวีโร        ทุกฺขสฺสนฺตกโร มุนิ  
<span class="LineNumber"> 008 </span>	อิมํ ทสฺสนมาคมฺม          สพฺพทุกฺขา ปมุจฺจเร ฯ  
<span class="LineNumber"> 009 </span>	ทิสฺวานาหํ เทวเทวํ        ลกฺขณํ อุปธารยึ  
<span class="LineNumber"> 010 </span>	พุทฺโธ นุ โข น วา พุทฺโธ   หนฺท ปสฺสามิ จกฺขุมํ ฯ  
<span class="LineNumber"> 011 </span>	สหสฺสารานิ จกฺกานิ        ทิสฺสนฺติ จรณุตฺตเม  
<span class="LineNumber"> 012 </span>	ลกฺขณานิสฺส ทิสฺวาน        นิฏฺํ คฺฉึ ตถาคเต ฯ  
<span class="LineNumber"> 013 </span>	สมฺมชฺชนึ คเหตฺวา         สมฺมชฺชิตฺวานหํ ตทา  
<span class="LineNumber"> 014 </span>	อฏฺ ปุปฺเผ สมาเนตฺวา     พุทฺธเสฏฺํ อปูชยึ ฯ  
<span class="LineNumber"> 015 </span>	ปูชยิตฺวาน ตํ พุทฺธํ         โอฆติณฺณมนาสวํ  
<span class="LineNumber"> 016 </span>	เอกํสํ อชินํ กตฺวา         นมสฺสึ โลกนายกํ ฯ  
<span class="LineNumber"> 017 </span>	เยน าเณน สมฺพุทฺโธ      วิหรติ อนาสโว  
<span class="LineNumber"> 018 </span>	ตํ าณํ กิตฺตยิสฺสามิ        สุณาถ มม ภาสโต ฯ  
<span class="LineNumber"> 019 </span>	สมุทฺธรยิมํ โลกํ           สยมฺภุ อมิโตทย  
<span class="LineNumber"> 020 </span>	ตว ทสฺสนมาคมฺม          กงฺขาโสตํ ตรนฺติ เต ฯ  
<span class="LineNumber"> 021 </span>#๑ ม. วิชฺชุตํ ฯ  
