<span class="LineNumber"> 001 </span>	เอตาสํ สนฺทมานานํ        สาคโร สมฺปฏิจฺฉติ  
<span class="LineNumber"> 002 </span>	ชหนฺติ ปุริมํ นามํ          สาคโรเตฺวว ายติ ฯ  
<span class="LineNumber"> 003 </span>	ตเถวิเม จตุวณฺณา         ปพฺพชิตฺวา ตวนฺติเก  
<span class="LineNumber"> 004 </span>	ชหนฺติ ปุริมํ นามํ          พุทฺธปุตฺตาติ ายเร ฯ  
<span class="LineNumber"> 005 </span>	ยถาปิ จนฺโท วิมโล        คจฺฉํ อากาสธาตุยา  
<span class="LineNumber"> 006 </span>	สพฺเพ ตารคเณ โลเก      อาภาย อติโรจติ ฯ  
<span class="LineNumber"> 007 </span>	ตเถว ตฺวํ มหาวีร         ปริวุโต เทวมานุเส  
<span class="LineNumber"> 008 </span>	พุทฺธกฺเขตฺตํ อติกฺกมฺม       ชลสิ สพฺพทา ตุวํ ฯ  
<span class="LineNumber"> 009 </span>	คมฺภีเร อุฏฺิตา อูมิ        น เวลํ อติวตฺตติ  
<span class="LineNumber"> 010 </span>	สพฺพเวลํ ปผุสฺสนฺติ         สฺจุณฺณา วิกิรนฺติ ตา ฯ  
<span class="LineNumber"> 011 </span>	ตเถว ติตฺถิยา โลเก       นานาทิฏฺี พหู ชนา  
<span class="LineNumber"> 012 </span>	ธมฺมํ ตริตุกามา เต        นาติวตฺตนฺติ ตํ มุนึ ฯ  
<span class="LineNumber"> 013 </span>	สเจ จ ๑ ตํ ปาปุณนฺติ     ปฏิวาเรหิ ๒ จกฺขุม  
<span class="LineNumber"> 014 </span>	ตวนฺติกํ อุปาคนฺตฺวา        สฺจุณฺณาว ภวนฺติ เต ฯ  
<span class="LineNumber"> 015 </span>	ยถาปิ อุทเก ชาตา        กุมุทา มนฺทาลกา ๓ พหู  
<span class="LineNumber"> 016 </span>	อุปลิมฺปนฺติ โตเยน         กทฺทมกลเลน จ ฯ  
<span class="LineNumber"> 017 </span>	ตเถว พหุกา สตฺตา        โลเก ชาตา วิรูหเร  
<span class="LineNumber"> 018 </span>	อฑฺฑิตา ราคโทเสน        กทฺทเม กุมุทํ ยถา ฯ  
<span class="LineNumber"> 019 </span>	ยถา ปทุมํ ชลชํ           ชลมชฺเฌ วิโรจติ ๔  
<span class="LineNumber"> 020 </span>	น โส ลิมฺปติ โตเยน       ปริสุทฺโธ หิ เกสรี ฯ  
<span class="LineNumber"> 021 </span>#๑ ยุ. ว ฯ ๒ ม. ยุ. ปฏิวาเทหิ ฯ ๓ ยุ. มทฺทาลกา ฯ ๔ ม. ยุ. วิรูหติ ฯ  
