<span class="LineNumber"> 001 </span>	อายาเมน จตุพฺพีสา ๑     โยชนาสึสุ ๒ ตาวเท  
<span class="LineNumber"> 002 </span>	วิมานํ สุกตํ มยฺหํ          วิตฺถาเรน จตุทฺทสํ ฯ  
<span class="LineNumber"> 003 </span>	สตฺต กฺาสหสฺสานิ        ปริวาเรนฺติ มํ สทา  
<span class="LineNumber"> 004 </span>	โสณฺณมยฺจ ปลฺลงฺกํ        พฺยเมฺห อาสิ สุนิมฺมิตํ ฯ  
<span class="LineNumber"> 005 </span>	หตฺถิยานํ อสฺสยานํ         ทิพฺพยานํ อุปฏฺิตํ  
<span class="LineNumber"> 006 </span>	ปาสาทา สิวิกา เจว       นิพฺพตฺตนฺติ ยทิจฺฉกํ ฯ  
<span class="LineNumber"> 007 </span>	มณิมยา จ ปลฺลงฺกา        อฺเ สารมยา พหู  
<span class="LineNumber"> 008 </span>	นิพฺพตฺตนฺติ มมํ สพฺเพ       สีหาสนสฺสิทํ ผลํ ฯ  
<span class="LineNumber"> 009 </span>	โสณฺณมยา รูปิมยา         ผลิกา เวฬุริยามยา  
<span class="LineNumber"> 010 </span>	ปาทุกา อภิรุยฺหามิ         ปาทปิสฺสิทํ ผลํ ฯ  
<span class="LineNumber"> 011 </span>	จตุนวุเต อิโต กปฺเป       ยํ กมฺมมกรึ ตทา  
<span class="LineNumber"> 012 </span>	ทุคฺคตึ นาภิชานามิ         ปุฺกมฺมสฺสิทํ ผลํ ฯ  
<span class="LineNumber"> 013 </span>	เตสตฺตติ อิโต กปฺเป       อินฺทนามา ตโย ชนา  
<span class="LineNumber"> 014 </span>	เทฺวสตฺตติ อิโต กปฺเป      ตโย สุมนนามกา ฯ  
<span class="LineNumber"> 015 </span>	สมสตฺตติโต กปฺเป         ตโย วรุณนามกา  
<span class="LineNumber"> 016 </span>	สตฺตรตนสมฺปนฺนา          จตุทีปมฺหิ อิสฺสรา ฯ  
<span class="LineNumber"> 017 </span>	ปฏิสมฺภิทา จตสฺโส         วิโมกฺขาปิจ อฏฺิเม  
<span class="LineNumber"> 018 </span>	ฉฬภิฺา สจฺฉิกตา         กตํ พุทฺธสฺส สาสนนฺติ ฯ  
<span class="LineNumber"> 019 </span>	อิตฺถํ สุทํ อายสฺมา สีหาสนทายโก เถโร อิมา คาถาโย  
<span class="LineNumber"> 020 </span>อภาสิตฺถาติ ฯ  
<span class="LineNumber"> 021 </span>	สีหาสนทายกตฺเถรสฺส อปทานํ สมตฺตํ ฯ  
<span class="LineNumber"> 022 </span>#๑ ม. จตุพฺพีส ฯ ๒ ม. โยชนํ อาสิ ตาวเท ฯ  
