<span class="LineNumber"> 001 </span>	นิกฺขนฺเตนานุปพฺพชฺชึ        ปธานํ สุกตํ มยา  
<span class="LineNumber"> 002 </span>	กิเลเส ฌาปนตฺถาย        ปพฺพชึ อนคาริยํ ฯ  
<span class="LineNumber"> 003 </span>	อธิคนฺตฺวาน สพฺพฺู        พุทฺโธ โลเก สเทวเก  
<span class="LineNumber"> 004 </span>	อิมินา ๑ เม มหารฺํ ๒  อมตเภริมาหนิ ฯ  
<span class="LineNumber"> 005 </span>	โสทานิ ปตฺโต อมตํ        สนฺตํ ๓ ปทมนุตฺตรํ  
<span class="LineNumber"> 006 </span>	สพฺพาสเว ปริฺาย        วิหรามิ อนาสโว ฯ  
<span class="LineNumber"> 007 </span>	ปฏิสมฺภิทา จตสฺโส         วิโมกฺขาปิจ อฏฺิเม  
<span class="LineNumber"> 008 </span>	ฉฬภิฺา สจฺฉิกตา         กตํ พุทฺธสฺส สาสนนฺติ ฯ  
<span class="LineNumber"> 009 </span>	อิตฺถํ สุทํ อายสฺมา อฺาโกณฺฑฺโ ๔ เถโร อิมา คาถาโย  
<span class="LineNumber"> 010 </span>อภาสิตฺถาติ ฯ  
<span class="LineNumber"> 011 </span>	อฺาโกณฺฑฺตฺเถรสฺส อปทานํ สมตฺตํ ฯ  
<span class="LineNumber"> 012 </span>	ทสมํ ปิณฺโฑลภารทฺวาชตฺเถราปทานํ (๘)  
<span class="LineNumber"> 013 </span>	[๑๐] ปทุมุตฺตโร นาม ชิโน       สยมฺภู อคฺคปุคฺคโล  
<span class="LineNumber"> 014 </span>	ปุรโต หิมวนฺตสฺส          จิตฺตกูเฏ วสี ตทา ฯ  
<span class="LineNumber"> 015 </span>	อภีตรูโป ตตฺถาสึ          มิคราชา จตุกฺกโม  
<span class="LineNumber"> 016 </span>	ยสฺส ๕ สทฺทํ สุณิตฺวาน     วิกฺขมฺภนฺติ พหู ชนา ฯ  
<span class="LineNumber"> 017 </span>	สุผุลฺลํ ปทุมํ คยฺห          อุปคฺฉึ นราสภํ  
<span class="LineNumber"> 018 </span>	วุฏฺิตสฺส สมาธิมฺหา        พุทฺธสฺส อภิโรปยึ ฯ  
<span class="LineNumber"> 019 </span>#๑ ม. อิสินาเม มิคารฺเ ฯ ๒ ยุ. มิครฺเ ฯ ๓ ม. สนฺติปทมนุตฺตรํ ฯ  
<span class="LineNumber"> 020 </span>#๔ โป. อฺาตโกณฺฑฺโ ฯ ม. อฺาสิโกณฺฑฺโ ฯ ๕ ม. ตสฺส ฯ  
