<span class="LineNumber"> 001 </span>	เยนายํ โชติตา เสยฺยา     อาทาโสว สุสนฺถโต ฯ  
<span class="LineNumber"> 002 </span>	ตมหํ กิตฺตยิสฺสามิ          สุณาถ มม ภาสโต ฯ  
<span class="LineNumber"> 003 </span>	โสณฺณมยา รูปิมยา         อโถ เวฬุริยามยา  
<span class="LineNumber"> 004 </span>	นิพฺพตฺติสฺสนฺติ ปาสาทา      เยเกจิ มนโส ปิยา ฯ  
<span class="LineNumber"> 005 </span>	จตุสฏฺิกฺขตฺตุํ เทวินฺโท      เทวรชฺชํ กริสฺสติ  
<span class="LineNumber"> 006 </span>	สหสฺสกฺขตฺตุํ จกฺกวตฺติ       ภวิสฺสติ อนนฺตรา ฯ  
<span class="LineNumber"> 007 </span>	เอกวีสติกปฺปมฺหิ           วิมโล นาม ขตฺติโย  
<span class="LineNumber"> 008 </span>	จาตุรนฺโต วิชิตาวี         จกฺกวตฺติ ภวิสฺสติ ฯ  
<span class="LineNumber"> 009 </span>	นครํ เรณุวติ นาม         อิฏฺกาหิ สุมาปิตํ  
<span class="LineNumber"> 010 </span>	อายามโต ตีณิสตํ          จตุรสฺสสมายุตํ ฯ  
<span class="LineNumber"> 011 </span>	สุทสฺสโน นาม ปาสาโท     วิสุกมฺเมน มาปิโต  
<span class="LineNumber"> 012 </span>	กูฏาคารวรูเปโต          สตฺตรตนภูสิโต ฯ  
<span class="LineNumber"> 013 </span>	ทสสทฺทาวิวิตฺตนฺตํ          วิชฺชาธรสมากุลํ  
<span class="LineNumber"> 014 </span>	สุทสฺสนํว นครํ            เทวตานํ ภวิสฺสติ ฯ  
<span class="LineNumber"> 015 </span>	ปภา นิคฺคจฺฉเต ตสฺส       อุคฺคจฺฉนฺเตว สูริเย  
<span class="LineNumber"> 016 </span>	วิโรจิสฺสติ ตํ นิจฺจํ         สมนฺตา อฏฺโยชนํ ฯ  
<span class="LineNumber"> 017 </span>	กปฺปสตสหสฺสมฺหิ           โอกฺกากกุลสมฺภโว  
<span class="LineNumber"> 018 </span>	โคตโม นาม นาเมน       สตฺถา โลเก ภวิสฺสติ ฯ  
<span class="LineNumber"> 019 </span>	ตุสิตาว จวิตฺวาน          สุกฺกมูเลน โจทิโต  
<span class="LineNumber"> 020 </span>	โคตมสฺส ภควโต          อตฺรโช โส ภวิสฺสติ ฯ  
