<span class="LineNumber"> 001 </span>	ตสฺส รฺโ อหํ ปุตฺโต      จนฺทโน นาม ขตฺติโย  
<span class="LineNumber"> 002 </span>	ชาติมเทน ปตฺถทฺโธ        ยโสโภคมเทน จ ฯ  
<span class="LineNumber"> 003 </span>	นาคสตสหสฺสานิ           สพฺพาลงฺการภูสิตา  
<span class="LineNumber"> 004 </span>	ติธา ปภินฺนา มาตงฺคา      ปริวาเรนฺติ มํ สทา ฯ  
<span class="LineNumber"> 005 </span>	สพเลหิ ปเรโตหํ          อุยฺยานํ คนฺตุกามโก  
<span class="LineNumber"> 006 </span>	อารุยฺห สิริกํ นาคํ         นครา นิกฺขมึ ตทา ฯ  
<span class="LineNumber"> 007 </span>	จรเณน จ สมฺปนฺโน        คุตฺตทฺวาโร สุสํวุโต  
<span class="LineNumber"> 008 </span>	เทวโล นาม สมฺพุทฺโธ      อาคจฺฉิ ปุรโต มมํ ฯ  
<span class="LineNumber"> 009 </span>	เปเสตฺวา สิริกํ นาคํ       พุทฺธํ อาสาทยึ ตทา  
<span class="LineNumber"> 010 </span>	ตโต สฺชาตโกโปว ๑     นาโค นุทฺธรโก ๒ ปทํ ฯ  
<span class="LineNumber"> 011 </span>	นาคํ รุณฺณมนํ ๓ ทิสฺวา     พุทฺเธ โกปํ อกาสหํ  
<span class="LineNumber"> 012 </span>	วิเหยิตฺวา สมฺพุทฺธํ        อุยฺยานํ อคมาสหํ ฯ  
<span class="LineNumber"> 013 </span>	สาตํ ตตฺถ น วินฺทามิ       สิโร ปชฺชลิโต ยถา  
<span class="LineNumber"> 014 </span>	ปริฬาเหน ฑยฺหามิ         มจฺโฉว พลิสาทโก ฯ  
<span class="LineNumber"> 015 </span>	สสาครนฺตา ปวี          อาทิตฺตา วิย โหติ เม  
<span class="LineNumber"> 016 </span>	ปิตุ สนฺติกุปาคมฺม          อิทํ วจนมพฺรวึ ฯ  
<span class="LineNumber"> 017 </span>	อาสีวิสํว กุปิตํ            อคฺคิกฺขนฺธํว อาคตํ  
<span class="LineNumber"> 018 </span>	มตฺตํว กุฺชรํ ทนฺตึ         ยํ สยมฺภุํ อสาทยึ ฯ  
<span class="LineNumber"> 019 </span>	อาสาทิโต มยา พุทฺโธ      โฆโร อุคฺคตโป ชิโน  
<span class="LineNumber"> 020 </span>	ปุรา สพฺเพ วินสฺสาม       ขมาเปสฺสาม ตํ มุนึ ฯ  
<span class="LineNumber"> 021 </span>#๑ ม. ยุ. สฺชาตโกโป โส ฯ ๒ ม. ยุ. นุทฺธรเต ฯ ๓ ยุ. ทุฏฺมนํ ฯ  
