<span class="LineNumber"> 001 </span>	รโหคโต นิสีทิตฺวา         เอวํ จินฺเตสหํ ตทา  
<span class="LineNumber"> 002 </span>	โปเสนฺโต มาตาปิตโร      ปพฺพชฺชํ น ลภามหํ ฯ  
<span class="LineNumber"> 003 </span>	ตมนฺธการปิหิตา ๑        ติวิธคฺคีหิ ทยฺหเร  
<span class="LineNumber"> 004 </span>	เอตาทิเส ภเว ชาเต      นตฺถิ โกจิ วินายโก ฯ  
<span class="LineNumber"> 005 </span>	พุทฺโธ โลเก สมุปฺปนฺโน     ทิปฺเปติ ทานิ ๒ สาสนํ  
<span class="LineNumber"> 006 </span>	สกฺกา อุทฺธริตุํ อตฺตา       ปุฺกาเมน ชนฺตุนา ฯ  
<span class="LineNumber"> 007 </span>	อุคฺคยฺห ตีณิ สรเณ         ปริปุณฺณานิ โคปยึ  
<span class="LineNumber"> 008 </span>	เตน กมฺเมน สุกเตน       ปฏิมุกฺขามิ ทุคฺคตึ ฯ  
<span class="LineNumber"> 009 </span>	นิสโภ นาม สมโณ         พุทฺธสฺส อคฺคสาวโก  
<span class="LineNumber"> 010 </span>	ตํ อหํ อุปคนฺตฺวาน         สรณาคมนํ คหึ ฯ  
<span class="LineNumber"> 011 </span>	วสฺสสตสหสฺสานิ           อายุํ วิชฺชติ ตาวเท  
<span class="LineNumber"> 012 </span>	ตาวตา สรณาคมนํ         ปริปุณฺณํ อโคปยึ ฯ  
<span class="LineNumber"> 013 </span>	จริเม วตฺตมานมฺหิ         สรณนฺตมนุสฺสรึ  
<span class="LineNumber"> 014 </span>	เตน กมฺเมน สุกเตน       ตาวตึสํ อคฺฉหํ ฯ  
<span class="LineNumber"> 015 </span>	เทวโลกคโต สนฺโต        ปุฺกมฺมสมาหิโต  
<span class="LineNumber"> 016 </span>	ยํ ยํ เทสํ อุปปชฺชาม       อฏฺเหตู ลภามหํ ฯ  
<span class="LineNumber"> 017 </span>	ทิสาสุ ปูชิโต โหมิ         ติกฺขปฺโ ภวามหํ  
<span class="LineNumber"> 018 </span>	สพฺเพ เทวานุวตฺตนฺติ       อมิตโภคํ ลภามหํ ฯ  
<span class="LineNumber"> 019 </span>	สุวณฺณวณฺโณ สพฺพตฺถ        ปฏิภาโณ ๓ ภวามหํ  
<span class="LineNumber"> 020 </span>	มิตฺตานํ อจโล โหมิ        ยโส อจฺจุคฺคโต มม ฯ  
<span class="LineNumber"> 021 </span>#๑ ม. มหนฺธการปิหิตา ฯ ๒ ยุ. ชินสาสนํ ฯ ๓ ม. ยุ. ปฏิกฺกนฺโต ฯ  
