<span class="LineNumber"> 001 </span>	วิเวกมนุยุตฺโตหํ           อุปสนฺโต นิรูปธิ  
<span class="LineNumber"> 002 </span>	นาโคว พนฺธนํ เฉตฺวา      วิหรามิ อนาสโว ฯ  
<span class="LineNumber"> 003 </span>	เทฺวนวุเต อิโต กปฺเป      โพธึ โรเปสหํ ตทา  
<span class="LineNumber"> 004 </span>	ทุคฺคตึ นาภิชานามิ         โพธิโรปสฺสิทํ ผลํ ฯ  
<span class="LineNumber"> 005 </span>	จตุสฺสตฺตติโต กปฺเป        ทณฺฑเสโนติ วิสฺสุโต  
<span class="LineNumber"> 006 </span>	สตฺตรตนสมฺปนฺโน          จกฺกวตฺติ ตทา อหุ ฯ  
<span class="LineNumber"> 007 </span>	เตสตฺตติ อิโต กปฺเป       สตฺตาเหสุํ มหีปตี  
<span class="LineNumber"> 008 </span>	สมนฺตเนมิ นาเมน         ราชาโน จกฺกวตฺติโน ฯ  
<span class="LineNumber"> 009 </span>	ปุณฺณวีสติโต กปฺเป         ปุณฺณโก นาม ขตฺติโย  
<span class="LineNumber"> 010 </span>	สตฺตรตนสมฺปนฺโน          จกฺกวตฺติ มหพฺพโล ฯ  
<span class="LineNumber"> 011 </span>	ปฏิสมฺภิทา จตสฺโส         วิโมกฺขาปิจ อฏฺิเม  
<span class="LineNumber"> 012 </span>	ฉฬภิฺา สจฺฉิกตา         กตํ พุทฺธสฺส สาสนนฺติ ฯ  
<span class="LineNumber"> 013 </span>	อิตฺถํ สุทํ อายสฺมา อสนโพธิโย เถโร อิมา คาถาโย  
<span class="LineNumber"> 014 </span>อภาสิตฺถาติ ฯ  
<span class="LineNumber"> 015 </span>		อสนโพธิยตฺเถรสฺส อปทานํ สมตฺตํ ฯ  
<span class="LineNumber"> 016 </span>		อุทฺทานํ  
<span class="LineNumber"> 017 </span>	วีชนี สตรํสี จ            สยโนทกิ วาหิโส ๑                             
<span class="LineNumber"> 018 </span>	ปริวาโร ปทีปฺจ          ธโช ปทุมปูชโก  
<span class="LineNumber"> 019 </span>	โพธิ จ ทสโม วุตฺโต       คาถา เทฺวนวุตี ตถา ฯ  
<span class="LineNumber"> 020 </span>		วีชนีวคฺโค ฉฏฺโ ฯ  
<span class="LineNumber"> 021 </span>#๑ ม. ยุ. วาหิโย ฯ  
