<span class="LineNumber"> 001 </span>	ปฏิสมฺภิทา จตสฺโส         วิโมกฺขาปิจ อฏฺิเม  
<span class="LineNumber"> 002 </span>	ฉฬภิฺา สจฺฉิกตา         กตํ พุทฺธสฺส สาสนนฺติ ฯ  
<span class="LineNumber"> 003 </span>	อิตฺถํ สุทํ อายสฺมา จิตกปูชโก เถโร อิมา คาถาโย  
<span class="LineNumber"> 004 </span>อภาสิตฺถาติ ฯ  
<span class="LineNumber"> 005 </span>		จิตกปูชกตฺเถรสฺส อปทานํ สมตฺตํ ฯ  
<span class="LineNumber"> 006 </span>		สตฺตมํ พุทฺธสฺกตฺเถราปทานํ (๑๑๗)  
<span class="LineNumber"> 007 </span>	[๑๑๙] ยทา วิปสฺสิ โลกคฺโค       อายุสงฺขารโมสฺสชิ  
<span class="LineNumber"> 008 </span>	ปวี สมฺปกมฺปิตฺถ          เมทนีชลเมขลา ฯ  
<span class="LineNumber"> 009 </span>	โอคตํ ๑ วิตตํ มยฺหํ       สุจิ จิตฺตํ ปปฺจกํ  
<span class="LineNumber"> 010 </span>	ภวนํปิ ปกมฺปิตฺถ           พุทฺธสฺส อายุสงฺขเย ฯ  
<span class="LineNumber"> 011 </span>	ตาโส มยฺหํ สมุปฺปนฺโน      ภวเน สมฺปกมฺปิเต  
<span class="LineNumber"> 012 </span>	อุปฺปาโท นุ กิมตฺถาย       อาโลโก วิปุโล อหุ ฯ  
<span class="LineNumber"> 013 </span>	เวสฺสวณฺโณ อิธาคมฺม       นิพฺพาเปสิ มหาชนํ  
<span class="LineNumber"> 014 </span>	ปาณภูตํ ๒ ภยํ นตฺถิ       เอกคฺคา โหถ สคารวา ๓ ฯ  
<span class="LineNumber"> 015 </span>	อโห พุทฺโธ อโห ธมฺโม     อโห โน สตฺถุสมฺปทา  
<span class="LineNumber"> 016 </span>	ยสฺมึ อุปฺปชฺชมานสฺมึ        ปวี สมฺปกมฺปติ ฯ  
<span class="LineNumber"> 017 </span>	พุทฺธานุภาวํ กิตฺเตตฺวา      กปฺปํ สคฺคมฺห โมทหํ  
<span class="LineNumber"> 018 </span>	อวเสเสสุ กปฺเปสุ         กุสลํ กริตํ มยา ฯ  
<span class="LineNumber"> 019 </span>#๑ ม. ยุ. โอตตํ วิตตํ มยฺหํ สุวิจิตฺตวฏํสกํ ฯ ม. วิตตํ วิถตํ ฯ ๒ ม. ปาณภูเต ฯ  
<span class="LineNumber"> 020 </span>#๓ ม. ยุ. สุสํวุตา ฯ  
