<span class="LineNumber"> 001 </span>	ปฏิสมฺภิทา จตสฺโส         วิโมกฺขาปิจ อฏฺิเม  
<span class="LineNumber"> 002 </span>	ฉฬภิฺา สจฺฉิกตา         กตํ พุทฺธสฺส สาสนนฺติ ฯ  
<span class="LineNumber"> 003 </span>	อิตฺถํ สุทํ อายสฺมา มนฺทารวปุปฺผปูชโก เถโร อิมา คาถาโย  
<span class="LineNumber"> 004 </span>อภาสิตฺถาติ ฯ  
<span class="LineNumber"> 005 </span>	มนฺทารวปุปฺผปูชกตฺเถรสฺส อปทานํ สมตฺตํ ฯ  
<span class="LineNumber"> 006 </span>		ฉฏฺํ กทมฺพปุปฺผิยตฺเถราปทานํ (๑๕๖)  
<span class="LineNumber"> 007 </span>	[๑๕๘] หิมวนฺตสฺสวิทูเร           กุกฺกุโฏ นาม ปพฺพโต  
<span class="LineNumber"> 008 </span>	ตมฺหิ ปพฺพตปาทมฺหิ         สตฺต พุทฺธา วสนฺติ เต ฯ  
<span class="LineNumber"> 009 </span>	กทมฺพํ ปุปฺผิตํ ทิสฺวา        ทีปราชํว อุคฺคตํ  
<span class="LineNumber"> 010 </span>	อุโภหตฺเถหิ ปคฺคยฺห        สตฺต พุทฺเธ สโมกิรึ ฯ  
<span class="LineNumber"> 011 </span>	จตุนวุเต อิโต กปฺเป       ยํ ปุปฺผมภิโรปยึ  
<span class="LineNumber"> 012 </span>	ทุคฺคตึ นาภิชานามิ         พุทฺธปูชายิทํ ผลํ ฯ  
<span class="LineNumber"> 013 </span>	เทฺวนวุเต อิโต กปฺเป      สตฺตาสุํ ๑ ปุปฺผนามกา  
<span class="LineNumber"> 014 </span>	สตฺตรตนสมฺปนฺนา          จกฺกวตฺตี มหพฺพลา ฯ  
<span class="LineNumber"> 015 </span>	ปฏิสมฺภิทา จตสฺโส         วิโมกฺขาปิจ อฏฺิเม  
<span class="LineNumber"> 016 </span>	ฉฬภิฺา สจฺฉิกตา         กตํ พุทฺธสฺส สาสนนฺติ ฯ  
<span class="LineNumber"> 017 </span>	อิตฺถํ สุทํ อายสฺมา กทมฺพปุปฺผิโย เถโร อิมา คาถาโย  
<span class="LineNumber"> 018 </span>อภาสิตฺถาติ ฯ  
<span class="LineNumber"> 019 </span>		กทมฺพปุปฺผิยตฺเถรสฺส อปทานํ สมตฺตํ ฯ  
<span class="LineNumber"> 020 </span>#๑ ยุ. สตฺตาหุํ ผุลฺลนายกา ฯ  
