<span class="LineNumber"> 001 </span>	อิตฺถํ สุทํ อายสฺมา ภิกฺขทายโก เถโร อิมา คาถาโย  
<span class="LineNumber"> 002 </span>อภาสิตฺถาติ ฯ  
<span class="LineNumber"> 003 </span>		ภิกฺขทายกตฺเถรสฺส อปทานํ สมตฺตํ ฯ  
<span class="LineNumber"> 004 </span>		ทุติยํ าณสฺิกตฺเถราปทานํ (๑๐๒)  
<span class="LineNumber"> 005 </span>	[๑๐๔] สุวณฺณวณฺณํ สมฺพุทฺธํ         นิสภาชานิยํ ยถา  
<span class="LineNumber"> 006 </span>	ติธาปฺปภินฺนํ มาตงฺคํ        กุฺชรํว มเหสินํ ฯ  
<span class="LineNumber"> 007 </span>	โอภาเสนฺตํ ทิสา สพฺพา     สาลราชํว ๑ ปุปฺผิตํ  
<span class="LineNumber"> 008 </span>	รถิยา ปฏิปชฺชนฺตํ          โลกเชฏฺํ นรุตฺตมํ ๒ ฯ  
<span class="LineNumber"> 009 </span>	าเณ จิตฺตํ ปสาเทตฺวา     ปคฺคเหตฺวาน อฺชลึ  
<span class="LineNumber"> 010 </span>	ปสนฺนจิตฺโต สุมโน         สิทฺธตฺถํ อภิวาทยึ ฯ  
<span class="LineNumber"> 011 </span>	จตุนวุเต อิโต กปฺเป       ยํ กมฺมมกรึ ตทา  
<span class="LineNumber"> 012 </span>	ทุคฺคตึ นาภิชานามิ         าณสฺายิทํ ผลํ ฯ  
<span class="LineNumber"> 013 </span>	เตสตฺตติมฺหิโต กปฺเป       โสฬสาสุํ นรุตฺตมา  
<span class="LineNumber"> 014 </span>	สตฺตรตนสมฺปนฺนา          จกฺกวตฺตี มหพฺพลา ฯ  
<span class="LineNumber"> 015 </span>	ปฏิสมฺภิทา จตสฺโส         วิโมกฺขาปิจ อฏฺิเม  
<span class="LineNumber"> 016 </span>	ฉฬภิฺา สจฺฉิกตา         กตํ พุทฺธสฺส สาสนนฺติ ฯ  
<span class="LineNumber"> 017 </span>	อิตฺถํ สุทํ อายสฺมา าณสฺิโก เถโร อิมา คาถาโย  
<span class="LineNumber"> 018 </span>อภาสิตฺถาติ ฯ  
<span class="LineNumber"> 019 </span>		าณสฺิกตฺเถรสฺส อปทานํ สมตฺตํ ฯ  
<span class="LineNumber"> 020 </span>#๑ ม. ยุ. อุฬุราชํว ปูริตํ ฯ ๒ ม. อปสฺสหํ ฯ  
