<span class="LineNumber"> 001 </span>	ปาทุมฺชริ ปณฺณฺจ         กุฏิโท อคฺคปุปฺผิโย  
<span class="LineNumber"> 002 </span>	คาถาโย คณิตา เจตฺถ      เอกตาฬีสเมว จ ฯ  
<span class="LineNumber"> 003 </span>		โถมกวคฺโค ฉพฺพีสติโม ฯ  
<span class="LineNumber"> 004 </span>		______________  
<span class="LineNumber"> 005 </span>		สตฺตวีโส ปทุมุกฺเขปวคฺโค  
<span class="LineNumber"> 006 </span>	ปมํ อากาสุกฺขิปิยตฺเถราปทานํ (๒๖๑)  
<span class="LineNumber"> 007 </span>	[๒๖๓] สุวณฺณวณฺณํ สิทฺธตฺถํ         คจฺฉนฺตํ อนฺตราปเณ  
<span class="LineNumber"> 008 </span>	ชลชคฺเค ทุเว คยฺห        อุปคฺฉึ นราสภํ ฯ  
<span class="LineNumber"> 009 </span>	เอกฺจ ปุปฺผํ ปาเทสุ       พุทฺธเสฏฺสฺส นิกฺขิปึ  
<span class="LineNumber"> 010 </span>	เอกฺจ ปุปฺผํ ปคฺคยฺห       อากาเส อุกฺขิปึ อหํ ฯ  
<span class="LineNumber"> 011 </span>	จตุนวุเต อิโต กปฺเป       ยํ ปุปฺผมภิปูชยึ8  
<span class="LineNumber"> 012 </span>	ทุคฺคตึ นาภิชานามิ         ปุปฺผทานสฺสิทํ ผลํ ฯ  
<span class="LineNumber"> 013 </span>	อิโต พตฺตึสกปฺปมฺหิ ๑      เอโก อาสึ มหิปฺปติ  
<span class="LineNumber"> 014 </span>	อนฺตลิกฺขกโร นาม         จกฺกวตฺติ มหพฺพโล ฯ  
<span class="LineNumber"> 015 </span>	ปฏิสมฺภิทา จตสฺโส         วิโมกฺขาปิจ อฏฺิเม  
<span class="LineNumber"> 016 </span>	ฉฬภิฺา สจฺฉิกตา         กตํ พุทฺธสฺส สาสนนฺติ ฯ  
<span class="LineNumber"> 017 </span>	อิตฺถํ สุทํ อายสฺมา อากาสุกฺขิปิโย เถโร อิมา คาถาโย  
<span class="LineNumber"> 018 </span>อภาสิตฺถาติ ฯ  
<span class="LineNumber"> 019 </span>	อากาสุกฺขิปิยตฺเถรสฺส อปทานํ สมตฺตํ ฯ  
<span class="LineNumber"> 020 </span>#๑ ม. ฉตฺตึสกปฺปมฺหิ ฯ  
