<span class="LineNumber"> 001 </span>		ทุติยํ ผลทายกตฺเถราปทานํ (๒๘๒)  
<span class="LineNumber"> 002 </span>	[๒๘๔] สิเนรุสมสนฺโตโส          ธรณีธรสาทิโส ๑  
<span class="LineNumber"> 003 </span>	วุฏฺหิตฺวา สมาธิมฺหา       ภิกฺขาย มมุปฏฺิโต ฯ  
<span class="LineNumber"> 004 </span>	หรีตกึ ๒ อามลกํ         อมฺพํ ๓ ชมฺพพ วิเภทกํ  
<span class="LineNumber"> 005 </span>	โกลํ ภลฺลาตกํ เพลฺลํ ๔    ผารุสกผลานิ จ ฯ  
<span class="LineNumber"> 006 </span>	สิทฺธตฺถสฺส มเหสิสฺส        สพฺพโลกานุกมฺปิโน  
<span class="LineNumber"> 007 </span>	ตฺจ สพฺพํ มยา ทินฺนํ       วิปฺปสนฺเนน เจตสา ฯ  
<span class="LineNumber"> 008 </span>	จตุนวุเต อิโต กปฺเป       ยํ ผลํ อททึ ตทา  
<span class="LineNumber"> 009 </span>	ทุคฺคตึ นาภิชานามิ         ผลทานสฺสิทํ ผลํ ฯ  
<span class="LineNumber"> 010 </span>	สตฺตปฺาสิโต กปฺเป       เอกชฺโฌ นาม ขตฺติโย  
<span class="LineNumber"> 011 </span>	สตฺตรตนสมฺปนฺโน          จกฺกวตฺติ มหพฺพโล ฯ  
<span class="LineNumber"> 012 </span>	ปฏิสมฺภิทา จตสฺโส         วิโมกฺขาปิจ อฏฺิเม  
<span class="LineNumber"> 013 </span>	ฉฬภิฺา สจฺฉิกตา         กตํ พุทฺธสฺส สาสนนฺติ ฯ  
<span class="LineNumber"> 014 </span>	อิตฺถํ สุทํ อายสฺมา ผลทายโก เถโร อิมา คาถาโย  
<span class="LineNumber"> 015 </span>อภาสิตฺถาติ ฯ  
<span class="LineNumber"> 016 </span>		ผลทายกตฺเถรสฺส อปทานํ สมตฺตํ ฯ  
<span class="LineNumber"> 017 </span>		ตติยํ ปจฺจุคฺคมนิยตฺเถราปทานํ (๒๘๓)  
<span class="LineNumber"> 018 </span>	[๒๘๕] สีหํ ยถา วนจรํ           นิสภาชานิยํ ยถา  
<span class="LineNumber"> 019 </span>	กกุธํ วิลสนฺตํว            อาคจฺฉนฺตํ นราสภํ ฯ  
<span class="LineNumber"> 020 </span>#๑ ม. ธรณีสมสาทิโส ฯ ยุ. ธรณีธาริสาทิโส ฯ ๒ โป. ม. ยุ. หรีตกํ ฯ  
<span class="LineNumber"> 021 </span>#๓ ม. ยุ. อมฺพชมฺพุวิภีตกํ ฯ ๔ ม. พิลฺลํ ฯ  
