<span class="LineNumber"> 001 </span>		ทุติยํ ปุฬินปูชกตฺเถราปทานํ (๓๒๒)  
<span class="LineNumber"> 002 </span>	[๓๒๔] กกุธํ วิลสนฺตํว            นิสภาชานิยํ ยถา  
<span class="LineNumber"> 003 </span>	โอสธีว วิโรจนฺตํ          โอภาสนฺตํ นราสภํ ฯ  
<span class="LineNumber"> 004 </span>	อฺชลึ ปคฺคเหตฺวาน        อวนฺทึ สตฺถุโน อหํ  
<span class="LineNumber"> 005 </span>	สตฺถารํ ปริวณฺเณสึ         สกกมฺเมน โตสยึ ๑ ฯ  
<span class="LineNumber"> 006 </span>	สุสุทฺธํ ปุฬินํ คยฺหํ ๒       คตมคฺเค สโมกิรึ  
<span class="LineNumber"> 007 </span>	อุจฺฉงฺเคน คเหตฺวาน       วิปสฺสิสฺส มเหสิโน ฯ  
<span class="LineNumber"> 008 </span>	ตโต อุปฑฺฒปุฬินํ           วิปฺปสนฺเนน เจตสา  
<span class="LineNumber"> 009 </span>	ทิวาวิหาเร โอสิฺจึ        ทิปทินฺทสฺส ตาทิโน ฯ  
<span class="LineNumber"> 010 </span>	เอกนวุเต อิโต กปฺเป      ปุฬินํ ยํ อสิฺจิหํ  
<span class="LineNumber"> 011 </span>	ทุคฺคตึ นาภิชานามิ         ปุฬินสฺส อิทํ ผลํ ฯ  
<span class="LineNumber"> 012 </span>	ปฏิสมฺภิทา จตสฺโส         วิโมกฺขาปิจ อฏฺิเม  
<span class="LineNumber"> 013 </span>	ฉฬภิฺา สจฺฉิกตา         กตํ พุทฺธสฺส สาสนนฺติ ฯ  
<span class="LineNumber"> 014 </span>	อิตฺถํ สุทํ อายสฺมา ปุฬินปูชโก เถโร อิมา คาถาโย  
<span class="LineNumber"> 015 </span>อภาสิตฺถาติ ฯ  
<span class="LineNumber"> 016 </span>		ปุฬินปูชกตฺเถรสฺส อปทานํ สมตฺตํ ฯ  
<span class="LineNumber"> 017 </span>		ตติยํ หาสชนกตฺเถราปทานํ (๓๒๓)  
<span class="LineNumber"> 018 </span>	[๓๒๕] ทุมคฺเค ปํสุกูลิกํ ๓        ลคฺคํ ทิสฺวาน สตฺถุโน  
<span class="LineNumber"> 019 </span>	อฺชลึ ปคฺคเหตฺวาน        ภิยฺโย อุจฺจาริตํ มยา ฯ  
<span class="LineNumber"> 020 </span>#๑ ยุ. โตสิโต ฯ ๒ ม. ยุ. คยฺห ฯ ๓ ม. ปํสุกูลกํ ฯ  
