<span class="LineNumber"> 001 </span>	สตฺตสตฺตติเม กปฺเป        สโมกฺขรณนามโก ๑  
<span class="LineNumber"> 002 </span>	สตฺตรตนสมฺปนฺโน          จกฺกวตฺติ มหพฺพโล ฯ  
<span class="LineNumber"> 003 </span>	ปฏิสมฺภิทา จตสฺโส         วิโมกฺขาปิจ อฏฺิเม  
<span class="LineNumber"> 004 </span>	ฉฬภิฺา สจฺฉิกตา         กตํ พุทฺธสฺส สาสนนฺติ ฯ  
<span class="LineNumber"> 005 </span>	อิตฺถํ สุทํ อายสฺมา นาคเกสริโย เถโร อิมา คาถาโย  
<span class="LineNumber"> 006 </span>อภาสิตฺถาติ ฯ  
<span class="LineNumber"> 007 </span>		นาคเกสริยตฺเถรสฺส อปทานํ สมตฺตํ ฯ  
<span class="LineNumber"> 008 </span>		ตติยํ นฬินเกสริยตฺเถราปทานํ (๒๔๓)                                 
<span class="LineNumber"> 009 </span>	[๒๔๕] ชาตสฺสรสฺส เวมชฺเฌ       วสามิ ชลกุกฺกุโฏ  
<span class="LineNumber"> 010 </span>	อถทฺทสํ เทวเทวํ          คจฺฉนฺตํ อนิลฺชเส ฯ  
<span class="LineNumber"> 011 </span>	ตุณฺเฑน เกสรํ ๒ คยฺห     วิปฺปสนฺเนน เจตสา  
<span class="LineNumber"> 012 </span>	พุทฺธสฺส อภิโรเปสึ         ติสฺสสฺส โลกพนฺธุโน ฯ  
<span class="LineNumber"> 013 </span>	เทฺวนวุเต อิโต กปฺเป      ยํ ปุปฺผมภิปูชยึ  
<span class="LineNumber"> 014 </span>	ทุคฺคตึ นาภิชานามิ         พุทฺธปูชายิทํ ผลํ ฯ  
<span class="LineNumber"> 015 </span>	เตสตฺตติมฺหิ กปฺปมฺหิ        สตฺตปตฺตสนามโก ๓  
<span class="LineNumber"> 016 </span>	สตฺตรตนสมฺปนฺโน          จกฺกวตฺติ มหพฺพโล ฯ  
<span class="LineNumber"> 017 </span>	ปฏิสมฺภิทา จตสฺโส         วิโมกฺขาปิจ อฏฺิเม  
<span class="LineNumber"> 018 </span>	ฉฬภิฺา สจฺฉิกตา         กตํ พุทฺธสฺส สาสนนฺติ ฯ  
<span class="LineNumber"> 019 </span>#๑ ม. เตสตฺตติมฺหิ กปฺปมฺหิ สตฺตเกสรนามกา ฯ ยุ. ปโมกฺขรณนามโก ฯ  
<span class="LineNumber"> 020 </span>#๒ ม. ยุ. เกสรึ ฯ ๓ ม. สตฺตเกสรนามกา ... มหพฺพลา ฯ  
