<span class="LineNumber"> 001 </span>	ตมทฺทสาสึ สมฺพุทฺธํ         เทเสนฺตํ อมตํ ปทํ  
<span class="LineNumber"> 002 </span>	สกํ จิตฺตํ ปสาเทตฺวา       อคมาสึ สกํ ฆรํ ฯ  
<span class="LineNumber"> 003 </span>	ฉตฺตํ อลงฺกตํ คยฺห         อุปคฺฉึ นรุตฺตมํ  
<span class="LineNumber"> 004 </span>	หฏฺโ หฏฺเน จิตฺเตน      อากาเส อุกฺขิปึ อหํ ฯ  
<span class="LineNumber"> 005 </span>	สุสงฺคหิตยานํว            ทนฺโตว สาวกุตฺตโม  
<span class="LineNumber"> 006 </span>	อุปคนฺตฺวาน สมฺพุทฺธํ        มตฺถเก สมฺปติฏฺหิ ฯ  
<span class="LineNumber"> 007 </span>	อนุกมฺปโก การุณิโก        พุทฺโธ โลกคฺคนายโก  
<span class="LineNumber"> 008 </span>	ภิกฺขุสงฺเฆ นิสีทิตฺวา        อิมา คาถา อภาสถ ฯ  
<span class="LineNumber"> 009 </span>	เยน ฉตฺตมิทํ ทินฺนํ         อลงฺกตํ มโนรมํ  
<span class="LineNumber"> 010 </span>	เตน จิตฺตปฺปสาเทน        ทุคฺคตึ โส น คจฺฉติ ฯ  
<span class="LineNumber"> 011 </span>	สตฺตกฺขตฺตุํ จ เทเวสุ       เทวรชฺชํ กริสฺสติ  
<span class="LineNumber"> 012 </span>	ทฺวตฺตึสกฺขตฺตุํ ๑ ราชา จ   จกฺกวตฺติ ภวิสฺสติ ฯ  
<span class="LineNumber"> 013 </span>	กปฺปสตสหสฺสมฺหิ           โอกฺกากกุลสมฺภโว  
<span class="LineNumber"> 014 </span>	โคตโม นาม นาเมน ๒    สตฺถา โลเก ภวิสฺสติ ฯ  
<span class="LineNumber"> 015 </span>	ตสฺส ธมฺเมสุ ทายาโท      โอรโส ธมฺมนิมฺมิโต  
<span class="LineNumber"> 016 </span>	สพฺพาสเว ปริฺาย        นิพฺพายิสฺสตินาสโว ฯ  
<span class="LineNumber"> 017 </span>	พุทฺธสฺส คิรมฺาย         วาจาสภิมุทีริตํ  
<span class="LineNumber"> 018 </span>	ปสนฺนจิตฺโต สุมโน         ภิยฺโย หาสํ ชเนสหํ ฯ  
<span class="LineNumber"> 019 </span>	ชหิตฺวา มานุสํ โยนึ        ทิพฺพโยนึ ๓ สมชฺฌคํ  
<span class="LineNumber"> 020 </span>	วิมานมุตฺตมํ มยฺหํ          อพฺภุคฺคตํ มโนรมํ ฯ  
<span class="LineNumber"> 021 </span>#๑ ยุ. ฉตฺตึสกฺขตฺตุํ ฯ ๒ ม. โคตุเตน ฯ ๓ ยุ. เทวโยนึ ฯ  
