<span class="LineNumber"> 001 </span>	เตน กมฺมวิปาเกน         สีสทุกฺขํ อหุ มม  
<span class="LineNumber"> 002 </span>	สกฺเกสุ หฺมาเนสุ        ยทา หนิ วิฏฏุโภ ๑ ฯ  
<span class="LineNumber"> 003 </span>	ผุสฺสสฺสาหํ ปาวจเน        สาวเก ปริภาสยึ  
<span class="LineNumber"> 004 </span>	ยวํ ขาทถ ภุฺชถ          มา จ ภุฺชถ สาลิโย ฯ  
<span class="LineNumber"> 005 </span>	เตน กมฺมวิปาเกน         เตมาสํ ขาทิตํ ยวํ  
<span class="LineNumber"> 006 </span>	นิมนฺติโต พฺราหฺมเณน       เวรฺชายํ วสึ ตทา ฯ  
<span class="LineNumber"> 007 </span>	นิพฺพุทฺเธ วตฺตมานมฺหิ       มลฺลปุตฺตํ นิเสธยึ ๒  
<span class="LineNumber"> 008 </span>	เตน กมฺมวิปาเกน         ปิฏฺิทุกฺขํ อหุ มม ฯ  
<span class="LineNumber"> 009 </span>	ติกิจฺฉโก อหํ อาสึ         เสฏฺิปุตฺตํ วิเรจยึ  
<span class="LineNumber"> 010 </span>	เตน กมฺมวิปาเกน         โหติ ปกฺขนฺทิกํ มม ฯ  
<span class="LineNumber"> 011 </span>	อวจาหํ โชติปาโล         สุคตํ กสฺสปํ ตทา  
<span class="LineNumber"> 012 </span>	กุโต นุ โพธิมณฺฑสฺส        โพธิ ปรมทุลฺลภา ฯ  
<span class="LineNumber"> 013 </span>	เตน กมฺมวิปาเกน         อจรึ ทุกฺกรํ พหุํ  
<span class="LineNumber"> 014 </span>	ฉพฺพสฺสานุรุเวลายํ         ตโต โพธึ อปาปุณึ ฯ  
<span class="LineNumber"> 015 </span>	นาหํ เอเตน มคฺเคน       ปาปุณึ โพธิมุตฺตมํ  
<span class="LineNumber"> 016 </span>	กุมคฺเคน คเวสิสฺสํ         ปุพฺพกมฺเมน โจทิโต ๓ ฯ  
<span class="LineNumber"> 017 </span>	ปุฺปาปปริกฺขีโณ          สพฺพสนฺตาปวชฺชิโต  
<span class="LineNumber"> 018 </span>	อโสโก อนุปายาโส        นิพฺพายิสฺสํ อนาสโว ฯ  
<span class="LineNumber"> 019 </span>	เอวํ ชิโน วิยากาสิ        ภิกฺขุสงฺฆสฺส อตฺถโต ๔  
<span class="LineNumber"> 020 </span>	สพฺพาภิฺาพลปฺปตฺโต       อโนตตฺเต มหาสเรติ ฯ  
<span class="LineNumber"> 021 </span>#๑ โป. ม. วิฏฺฏุโภ ฯ ยุ. วิฑูฑโภ ฯ ๒ ม. วิเหยึ ฯ ๓ ม. วาริโต ฯ  
<span class="LineNumber"> 022 </span>#ยุ. การิโต ฯ ๔ ม. ยุ. อคฺคโต ฯ  
