<span class="LineNumber"> 001 </span>	มณฺฑเป รุกฺขมูเล วา       วสโต สุฺเก ฆเร  
<span class="LineNumber"> 002 </span>	ธาเรติ ทุสฺสฉทนํ          สมนฺตา พฺยามโต มม ฯ  
<span class="LineNumber"> 003 </span>	อวิฺตฺตํ ๑ นิวาเสมิ      จีวรํ ปจฺจยฺจหํ  
<span class="LineNumber"> 004 </span>	ลาภิมฺหิ ๒ อนฺนปานสฺส     อุตฺตเรยฺยสฺสิทํ ผลํ ฯ  
<span class="LineNumber"> 005 </span>	สตสหสฺเส อิโต กปฺเป      ยํ กมฺมมกรึ ตทา  
<span class="LineNumber"> 006 </span>	ทุคฺคตึ นาภิชานามิ         วตฺถทานสฺสิทํ ผลํ ฯ  
<span class="LineNumber"> 007 </span>	ปฏิสมฺภิทา จตสฺโส         วิโมกฺขาปิจ อฏฺิเม  
<span class="LineNumber"> 008 </span>	ฉฬภิฺา สจฺฉิกตา         กตํ พุทฺธสฺส สาสนนฺติ ฯ  
<span class="LineNumber"> 009 </span>	อิตฺถํ สุทํ อายสฺมา อุตฺตเรยฺยทายโก เถโร อิมา คาถาโย  
<span class="LineNumber"> 010 </span>อภาสิตฺถาติ ฯ  
<span class="LineNumber"> 011 </span>	อุตฺตเรยฺยทายกตฺเถรสฺส อปทานํ สมตฺตํ ฯ  
<span class="LineNumber"> 012 </span>		นวมํ ธมฺมสฺสวนิยตฺเถราปทานํ (๓๓๙)  
<span class="LineNumber"> 013 </span>	[๓๔๑] ปทุมุตฺตโร นาม ชิโน       สพฺพธมฺมาน ปารคู  
<span class="LineNumber"> 014 </span>	จตุสจฺจํ ปกาเสนฺโต        สนฺตาเรติ ๓ พหุชฺชนํ ฯ  
<span class="LineNumber"> 015 </span>	อหํ เตน สมเยน          ชฏิโล อุคฺคตาปโน  
<span class="LineNumber"> 016 </span>	ธุนนฺโต วากจีรานิ         คจฺฉามิ อมฺพเร ตทา ฯ  
<span class="LineNumber"> 017 </span>	พุทฺธเสฏฺสฺส อุปริ         คนฺตุํ น วิสหามหํ  
<span class="LineNumber"> 018 </span>	ปกฺขีว เสลมาปชฺช ๔      คมนํ น ลภินฺตทา ๕ ฯ  
<span class="LineNumber"> 019 </span>#๑ ยุ. อวิฺตฺติ นิเสวามิ ฯ ๒ ม. ลาภี ฯ ยุ. ลาภีหิ ฯ ๓ ม. สนฺตาเรสิ พหุํ ชนํ ฯ  
<span class="LineNumber"> 020 </span>#๔ ม. ยุ. เสลมาสชฺช ฯ ๕ ม. น ลภามหํ ฯ ยุ. น ลเภ ตทา ฯ  
