<span class="LineNumber"> 001 </span>	อสฺสฏฺเก ผลมเย         อโถ โปกฺขรปตฺตเก  
<span class="LineNumber"> 002 </span>	มธุปานกสงฺเข จ          ลภามิ ถาลเก อหํ ฯ  
<span class="LineNumber"> 003 </span>	วตฺเต คุเณ ปฏิปตฺตึ ๑     อาจารกิริยาสุ จ  
<span class="LineNumber"> 004 </span>	อิเม คุเณ ปฏิลเภ         ตสฺส นิสฺสนฺทโต อหํ ฯ  
<span class="LineNumber"> 005 </span>	เภสชฺชํ สุคเต ทตฺวา       สงฺเฆ คณวรุตฺตเม  
<span class="LineNumber"> 006 </span>	ทสานิสํเส อนุโภมิ         กมฺมานุจฺฉวิเก มม ฯ  
<span class="LineNumber"> 007 </span>	อายุวา พลวา ธีโร        วณฺณวา ยสวา สุขี  
<span class="LineNumber"> 008 </span>	อนุปทฺทโว อนีติ จ         โหมิ ๒ อปจิโต สทา  
<span class="LineNumber"> 009 </span>	น เม ปิยวิโยคตฺถิ         ตสฺส นิสฺสนฺทโต มม ฯ  
<span class="LineNumber"> 010 </span>	อุปาหเน ชิเน ทตฺวา       สงฺเฆ คณวรุตฺตเม  
<span class="LineNumber"> 011 </span>	ตีณานิสํเส อนุโภมิ         กมฺมานุจฺฉวิเก มม ฯ  
<span class="LineNumber"> 012 </span>	หตฺถิยานํ อสฺสยานํ         สิวิกํ สนฺทมานิกํ  
<span class="LineNumber"> 013 </span>	สฏฺี รถสหสฺสานิ          ปริวาเรนฺติ มํ สทา ฯ  
<span class="LineNumber"> 014 </span>	มณิมยา ตมฺพมยา ๓       โสณฺณรชตปาทุกา  
<span class="LineNumber"> 015 </span>	นิพฺพตฺตนฺติ ปทุทฺธาเร       ภเว สํสรโต มม ฯ  
<span class="LineNumber"> 016 </span>	นิยามํ ปฏิธาวนฺติ ๔       อาจารคุณโสธนํ ๕  
<span class="LineNumber"> 017 </span>	อิเม คุเณ ปฏิลเภ         ตสฺส นิสฺสนฺทโต อหํ ฯ  
<span class="LineNumber"> 018 </span>	ปาทุเก สุคเต ทตฺวา       สงฺเฆ คุณวรุตฺตเม  
<span class="LineNumber"> 019 </span>	อิทฺธิปาทุกมารุยฺห          วิหรามิ ยถิจฺฉกํ ฯ  
<span class="LineNumber"> 020 </span>#๑ ม. ปฏิปตฺติ ฯ ยุ. ปฏิลเภ ฯ ๒ ยุ. โภมิ จาปจิโต สทา ฯ ๓ ยุ. มณฺฑลกา ฯ  
<span class="LineNumber"> 021 </span>#๔ ม. สติ ธาวนฺติ ฯ ๕ ม. อาคุอาจารโสธนํ ฯ  
