<span class="LineNumber"> 001 </span>	สหสฺสกฺขตฺตุํ ราชา จ       จกฺกวตฺติ อโหสหํ  
<span class="LineNumber"> 002 </span>	ปเทสรชฺชํ ๑ วิปุลํ        คณนาโต ๒ อสงฺขยํ ฯ  
<span class="LineNumber"> 003 </span>	อิธ มานุสเก รชฺเช ๓     ปริสา โหนฺติ พนฺธวา  
<span class="LineNumber"> 004 </span>	ปจฺฉิเม ภวสมฺปตฺเต        วาเสฏฺโ นาม พฺราหฺมโณ ฯ  
<span class="LineNumber"> 005 </span>	อสีติโกฏินิจฺจโย           ตสฺส ปุตฺโต อโหสหํ  
<span class="LineNumber"> 006 </span>	เสโล อิติ มม นามํ        ฉฬงฺเค ปารมึ คโต ฯ  
<span class="LineNumber"> 007 </span>	ชงฺฆาวิหารํ วิจรํ          สสิสฺเสหิ ปุรกฺขโต  
<span class="LineNumber"> 008 </span>	ชฏาภารภริตํปิ ๔         เกนิยํ นาม ตาปสํ ฯ  
<span class="LineNumber"> 009 </span>	ปฏิยตฺตาหุตึ ทิสฺวา         อิทํ วจนมพฺรวึ  
<span class="LineNumber"> 010 </span>	อาวาโห วา วิวาโห วา    ราชา วา เต นิมนฺติโต ฯ  
<span class="LineNumber"> 011 </span>	อาหุตึ ยิฏฺุกาโมหํ         พฺราหฺมเณ เทวสมฺมเต  
<span class="LineNumber"> 012 </span>	น นิมนฺเตมิ ราชานํ        อาหุติ เม น วิชฺชติ ฯ  
<span class="LineNumber"> 013 </span>	น จตฺถิ มยฺหมาวาโห       วิวาโห เม น วิชฺชติ  
<span class="LineNumber"> 014 </span>	สกฺยานํ นนฺทิชนโน         เสฏฺโ โลเก สเทวเก ฯ  
<span class="LineNumber"> 015 </span>	สพฺพโลกหิตตฺถาสิ ๕       สพฺพสตฺตสุขาวโห  
<span class="LineNumber"> 016 </span>	โส เม นิมนฺติโต อชฺช      ตสฺเสตํ ปฏิยาทนํ ฯ  
<span class="LineNumber"> 017 </span>	ตมฺพรุสกวณฺณาโภ          อปฺปเมยฺโย อนูปโม  
<span class="LineNumber"> 018 </span>	รูเปนาสทิโส พุทฺโธ        สฺวาตนาย นิมนฺติโต ฯ  
<span class="LineNumber"> 019 </span>	อุกฺกามุขปหฏฺโ ๖ จ ๗   ขทิรงฺคารสนฺนิโภ  
<span class="LineNumber"> 020 </span>	วิชฺชูปโม มหาวีโร         โส เม นาโถ ๘ นิมนฺติโต ฯ  
<span class="LineNumber"> 021 </span>#๑ ม. ยุ. เทวรชฺชํ กโรนฺตสฺส ฯ ๒ ม. ยุ. มหาเทวา อวนฺทิสุํ ฯ ๓ ม. รชฺชํ ฯ  
<span class="LineNumber"> 022 </span>#๔ ม. ชฏาภาริกภริตํ ฯ ยุ. ชฏาภารภริตํ ฯ ๕ ม. ยุ. สพฺพโลกหิตตฺถาย ฯ  
<span class="LineNumber"> 023 </span>#๖ ยุ. อุกฺกามุขปหโต ว ฯ ๗ ม. ว ฯ ๘ ม. ยุ. พุทฺโธ ฯ  
