<span class="LineNumber"> 001 </span>	มม เอวํ สรนฺตสฺส ๑      ภควาปิ อนุสฺสริ  
<span class="LineNumber"> 002 </span>	พุทฺธํ อนุสฺสรนฺตสฺส         ปีติ เม โหติ ตาวเท ฯ  
<span class="LineNumber"> 003 </span>	กาลฺจ ปุนราคมฺม         มํ อุเปสิ มหามุนิ  
<span class="LineNumber"> 004 </span>	สมฺปตฺเตปิ ๒ น ชานามิ    อยํ พุทฺโธ มหามุนิ ฯ  
<span class="LineNumber"> 005 </span>	อนุกมฺปโก การุณิโก        ปิยทสฺสี มหามุนิ  
<span class="LineNumber"> 006 </span>	สฺชานาเปสิ อตฺตานํ       อหํ พุทฺโธ สเทวเก ฯ  
<span class="LineNumber"> 007 </span>	สฺชานิตฺวาน สมฺพุทฺธํ       ปิยทสฺสึ มหามุนึ  
<span class="LineNumber"> 008 </span>	สกํ จิตฺตํ ปสาเทตฺวา       อิทํ วจนมพฺรวึ ฯ  
<span class="LineNumber"> 009 </span>	สพฺเพ ๓ ปีเ จ ปลฺลงฺเก  อาสนฺทีสุ นิสีทเร  
<span class="LineNumber"> 010 </span>	ตุวํปิ สพฺพทยาวี ๔        นิสีท รุจิราสเน ๕ ฯ  
<span class="LineNumber"> 011 </span>	สพฺพรตนมยํ ปีํ           นิมฺมินิตฺวาน ตาวเท  
<span class="LineNumber"> 012 </span>	ปิยทสฺสิสฺส มุนิโน          อาสนํ อิทฺธินิมฺมิตํ ฯ  
<span class="LineNumber"> 013 </span>	รตเนว ๖ นิสินฺนสฺส       ปีเก อิทฺธินิมฺมิเต  
<span class="LineNumber"> 014 </span>	กุมฺภมตฺตํ ชมฺพุผลํ          อทาสึ ตาวเท อหํ ฯ  
<span class="LineNumber"> 015 </span>	มม หาสํ ชเนตฺวาน        ปริภุฺชิ มหามุนิ  
<span class="LineNumber"> 016 </span>	ตทา จิตฺตํ ปสาเทตฺวา      สตฺถารํ อภิวาทยึ ฯ  
<span class="LineNumber"> 017 </span>	ปิยทสฺสี ตุ ภควา          โลกเชฏฺโ นราสโภ  
<span class="LineNumber"> 018 </span>	รตนาสนมาสินฺโน          อิมา คาถา อภาสถ ฯ  
<span class="LineNumber"> 019 </span>	โย เม รตนมยํ ปีํ        อมตฺจ ผลํ อทา  
<span class="LineNumber"> 020 </span>	ตมหํ กิตฺตยิสฺสามิ          สุณาถ มม ภาสโต ฯ  
<span class="LineNumber"> 021 </span>#๑ ม. ยุ. สรนฺตมฺหิ ฯ ๒ ยุ. สมฺปตฺโตปิ ฯ ๓ ม. ยุ. อฺเ ฯ ๔ ม. ตุวมฺปิ  
<span class="LineNumber"> 022 </span>#สพฺพทสฺสาวี ฯ ยุ. ตุวํสิ ... ฯ ๕ ม. ยุ. รตนาสเน ฯ ๖ ม. ยุ. รตเน จ ฯ  
