<span class="LineNumber"> 001 </span>	สฺวาคตํ วต เม อาสิ       มม พุทฺธสฺส สนฺติเก  
<span class="LineNumber"> 002 </span>	ติสฺโส วิชฺชา อนุปฺปตฺตา     กตํ พุทฺธสฺส สาสนํ ฯ  
<span class="LineNumber"> 003 </span>	ปฏิสมฺภิทา จตสฺโส         วิโมกฺขาปิจ อฏฺิเม  
<span class="LineNumber"> 004 </span>	ฉฬภิฺา สจฺฉิกตา         กตํ พุทฺธสฺส สาสนนฺติ ฯ  
<span class="LineNumber"> 005 </span>	อิตฺถํ สุทํ อายสฺมา เหมโก เถโร อิมา คาถาโย  
<span class="LineNumber"> 006 </span>อภาสิตฺถาติ ฯ  
<span class="LineNumber"> 007 </span>		เหมกตฺเถรสฺส อปทานํ สมตฺตํ ฯ  
<span class="LineNumber"> 008 </span>		อฏฺารสมํ ภาณวารํ ฯ  
<span class="LineNumber"> 009 </span>		อฏฺมํ โตเทยฺยตฺเถราปทานํ  (๔๐๘)  
<span class="LineNumber"> 010 </span>	[๔๑๐] ราชา วิชิตชโย ๑ นาม    เกตุมติปุรุตฺตเม  
<span class="LineNumber"> 011 </span>	สูโร วิกฺกมสมฺปนฺโน        ปุรมชฺฌาวสี ตทา ฯ  
<span class="LineNumber"> 012 </span>	ตสฺส รฺโ ปมตฺตสฺส       รฏฺวิสา ๒ สมุฏฺหุํ  
<span class="LineNumber"> 013 </span>	อุตฺตรา ๓ ตุณฺฑิกา เจว    รฏฺํ วิทฺธํสยุํ ตทา ฯ  
<span class="LineNumber"> 014 </span>	ปจฺจนฺเต กุปฺปิเต ขิปฺปํ      สนฺนิปาเตสิรินฺทโม  
<span class="LineNumber"> 015 </span>	ภเฏ เจว พลตฺเถ จ       อรึ นิคฺคาหยิ ตทา ฯ  
<span class="LineNumber"> 016 </span>	หตฺถาโรหา อนีกตฺถา       สูรา จ วมฺมโยธิโน ๔  
<span class="LineNumber"> 017 </span>	ธนุคฺคหา จ รถิกา ๕      สพฺเพ สนฺนิปตุํ ตทา ฯ  
<span class="LineNumber"> 018 </span>	อาฬารกา กปฺปกา จ       นฺหาปกา มาลการกา  
<span class="LineNumber"> 019 </span>	สูรา วิชิตสงฺคามา         สพฺเพ สนฺนิปตุํ ตทา ฯ  
<span class="LineNumber"> 020 </span>#๑ ม. อชิตฺชโย ฯ ยุ. ชิตฺชโย ฯ ๒ ม. ยุ. อฏวิโย ฯ ๓ ม. โอตารา ฯ ยุ. โอจรา ฯ  
<span class="LineNumber"> 021 </span>#๔ ม. ยุ. จมฺมโยธิโน ฯ ๕ ม. ยุ. อุคฺคา จ ฯ  
