<span class="LineNumber"> 001 </span>	วิสฺสฏฺโ โหหิ มา ภายิ      ลทฺโธ โชติรโส ตยา  
<span class="LineNumber"> 002 </span>	ยํ ตุยฺหํ ปตฺถิตํ สพฺพํ         ปริปูเรสฺสตาสนํ ๑ ฯ  
<span class="LineNumber"> 003 </span>	น ๒ โถกํ สุกตํ ปุฺํ       ปุฺกฺเขตฺเต อนุตฺตเร  
<span class="LineNumber"> 004 </span>	สกฺกา อุทฺธริตุํ อตฺตา        ยสฺส จิตฺตํ สุนีหิตํ ๓ ฯ  
<span class="LineNumber"> 005 </span>	อิมินา อาสนทาเนน         เจตนาปณิธีหิ จ  
<span class="LineNumber"> 006 </span>	กปฺปสตสหสฺสานิ            วินิปาตํ น คจฺฉติ ฯ  
<span class="LineNumber"> 007 </span>	ปฺาสกฺขตฺตุํ เทวินฺโท       เทวรชฺชํ กริสฺสติ  
<span class="LineNumber"> 008 </span>	อสีติกฺขตฺตุํ ราชา จ         จกฺกวตฺติ ภวิสฺสติ ฯ  
<span class="LineNumber"> 009 </span>	ปเทสรชฺชํ วิปุลํ            คณนาโต อสงฺขยํ  
<span class="LineNumber"> 010 </span>	สพฺพตฺถ สุขิโต หุตฺวา        สํสาเร สํสริสฺสติ ฯ  
<span class="LineNumber"> 011 </span>	อิทํ วตฺวาน สมฺพุทฺโธ        ชลชุตฺตมนามโก  
<span class="LineNumber"> 012 </span>	นภํ อพฺภุคฺคมิ ธีโร          หํสราชาว อมฺพเร ฯห  
<span class="LineNumber"> 013 </span>	หตฺถิยานํ อสฺสยานํ          สรถํ สนฺทมานิกํ  
<span class="LineNumber"> 014 </span>	ลภามิ สพฺพเมเวตํ          เอกาสนสฺสิทํ ผลํ ฯ  
<span class="LineNumber"> 015 </span>	กานนํ ปวิสิตฺวาน           ยทา อิจฺฉามิ อาสนํ  
<span class="LineNumber"> 016 </span>	มม สงฺกปฺปมฺาย          ปลฺลงฺโก อุปติฏฺติ ฯ  
<span class="LineNumber"> 017 </span>	วาริมชฺฌคโต สนฺโต         ยทา อิจฺฉามิ อาสนํ  
<span class="LineNumber"> 018 </span>	มม สงฺกปฺปมฺาย          ปลฺลงฺโก อุปติฏฺติ ฯ  
<span class="LineNumber"> 019 </span>	ยํ ยํ โยนูปปชฺชามิ          เทวตฺตํ อถ มานุสํ  
<span class="LineNumber"> 020 </span>	ปลฺลงฺกสตสหสฺสานิ          ปริวาเรนฺติ มํ สทา ฯ  
<span class="LineNumber"> 021 </span>#๑ ม. ยุ. ปริปูริสฺสตินาคเต ฯ ๒ ม. น โมฆํ ตํ กตํ ตุยฺหํ ฯ ยุ. น โถกํ ตํ  
<span class="LineNumber"> 022 </span>#กตํ ตุยฺหํ ฯ ๓ ม. ยุ. ปณีหิตํ ฯ  
