<span class="LineNumber"> 001 </span>	ตทาหํ พฺราหฺมโณ หุตฺวา      วิสฺสุโต เวทปารคู  
<span class="LineNumber"> 002 </span>	ทิวาวิหารํ วิจรํ            อทฺทสํ โลกนายกํ ฯ  
<span class="LineNumber"> 003 </span>	จตุสจฺจํ ปกาเสนฺตํ          โพธยนฺตํ สเทวกํ  
<span class="LineNumber"> 004 </span>	สสาวกํ ๑ จิตฺตกถิกํ        วณฺณยนฺตํ มหาชเน ฯ  
<span class="LineNumber"> 005 </span>	ตทา มุทิตจิตฺโตหํ           นิมนฺเตตฺวา ตถาคตํ  
<span class="LineNumber"> 006 </span>	นานารตฺเตหิ วตฺเถหิ        อลงฺกริตฺวาน มณฺฑปํ ฯ  
<span class="LineNumber"> 007 </span>	นานารตนปชฺโชตํ           สสงฺฆํ โภชยึ ตหึ  
<span class="LineNumber"> 008 </span>	โภชยิตฺวาน สตฺตาหํ         นานคฺครสโภชนํ ฯ  
<span class="LineNumber"> 009 </span>	นานาจิตฺเตหิ ปุปฺเผหิ        ปูชยิตฺวา สสาวกํ  
<span class="LineNumber"> 010 </span>	นิปจฺจ ปาทมูลมฺหิ           ตํ านํ ปตฺถยึ อหํ ฯ  
<span class="LineNumber"> 011 </span>	ตทา มุนิวโร อาห          กรุโณ ๒ กรุณาลโย  
<span class="LineNumber"> 012 </span>	ปสฺสเถตํ ทิชวรํ            ปทุมานนโลจนํ ฯ  
<span class="LineNumber"> 013 </span>	ปีติปามุชฺชพหุลํ             สมุทฺธคฺคตนุรุหํ ๓  
<span class="LineNumber"> 014 </span>	หาสาวหํ ๔ วิสาลกฺขํ       มม ๕ สาสนสาลยํ ฯ  
<span class="LineNumber"> 015 </span>	มม ปาทมูเล ปติตํ          เอกวตฺตํ สุมานสํ  
<span class="LineNumber"> 016 </span>	เอส ปตฺเถติ ตํ านํ        วิจิตฺตกถิกตฺตนํ ๖ ฯ  
<span class="LineNumber"> 017 </span>	สตสหสฺเส อิโต กปฺเป       โอกฺกากกุลสมฺภโว  
<span class="LineNumber"> 018 </span>	โคตโม นาม นาเมน        สตฺถา โลเก ภวิสฺสติ ฯ  
<span class="LineNumber"> 019 </span>	ตสฺส ธมฺเมสุ ทายาโท       โอรโส ธมฺมนิมฺมิโต  
<span class="LineNumber"> 020 </span>	กุมารกสฺสโป นาม          เหสฺสติ สตฺถุสาวโก ฯ  
<span class="LineNumber"> 021 </span>#๑ ม. ยุ. วิจิตฺตกถิกานคฺคํ ฯ ๒ ม. ยุ. กรุเณกรสาสโย ฯ ๓ ม. ยุ.  
<span class="LineNumber"> 022 </span>#สมุคฺคตตนูรุหํ ฯ อิโต ปรํ อีทิสเมว ฯ ๔ ม. หาสมฺหิตวิสาลกฺขํ ฯ ๕ ม. ยุ.  
<span class="LineNumber"> 023 </span>#๖ ยุ. วิจิตฺตกถิกตฺถทํ ฯ  
