<span class="LineNumber"> 001 </span>	กิเลสา ฌาปิตา มยฺหํ        ภวา สพฺเพ สมูหตา  
<span class="LineNumber"> 002 </span>	นาโคว พนฺธนํ เฉตฺวา       วิหรามิ อนาสโว ฯ  
<span class="LineNumber"> 003 </span>	สฺวาคตํ วต เม อาสิ        มม พุทฺธสฺส สนฺติเก  
<span class="LineNumber"> 004 </span>	ติสฺโส วิชฺชา อนุปฺปตฺตา      กตํ พุทฺธสฺส สาสนํ ฯ  
<span class="LineNumber"> 005 </span>	ปฏิสมฺภิทา จตสฺโส          วิโมกฺขาปิจ อฏฺิเม  
<span class="LineNumber"> 006 </span>	ฉฬภิฺา สจฺฉิกตา          กตํ พุทฺธสฺส สาสนนฺติ ฯ  
<span class="LineNumber"> 007 </span>	อิตฺถํ สุทํ อายสฺมา ภิสทายโก เถโร อิมา คาถาโย อภาสิตฺถาติ ฯ  
<span class="LineNumber"> 008 </span>		 ภิสทายกตฺเถรสฺส อปทานํ สมตฺตํ ฯ  
<span class="LineNumber"> 009 </span>		จตุตฺถํ าณตฺถวิกตฺเถราปทานํ (๔๘๔)  
<span class="LineNumber"> 010 </span>	[๗๔] ทกฺขิเณ หิมวนฺตสฺส          สุกโต อสฺสโม มม  
<span class="LineNumber"> 011 </span>	อุตฺตมตฺถํ คเวสนฺโต         วสามิ ปวเน ตทา ฯ  
<span class="LineNumber"> 012 </span>	ลาภาลาเภน สนฺตุฏฺโ       มูเลน จ ผเลน จ  
<span class="LineNumber"> 013 </span>	อโนมสนฺโต ๑ อจริ ๒     วสามิ เอกโก อหํ ฯ  
<span class="LineNumber"> 014 </span>	สุเมโธ นาม สมฺพุทฺโธ       โลเก อุปฺปชฺชิ ตาวเท  
<span class="LineNumber"> 015 </span>	จตุสจฺจํ ปกาเสติ           อุทฺธรนฺโต มหาชนํ ฯ  
<span class="LineNumber"> 016 </span>	นาหํ สุโณมิ สมฺพุทฺธํ         นปิ เม โกจิ สาสติ  
<span class="LineNumber"> 017 </span>	อฏฺวสฺเส อติกฺกนฺเต        อสฺโสสึ โลกนายกํ ฯ  
<span class="LineNumber"> 018 </span>	อคฺคึ ทารุํ นิหริตฺวา         สมฺมชฺชิตฺวาน อสฺสมํ  
<span class="LineNumber"> 019 </span>	ขาริภารํ คเหตฺวาน         นิกฺขมึ ปวนา อหํ ฯ  
<span class="LineNumber"> 020 </span>#๑ ม. อเนฺวสนฺโต อาจริยํ ฯ ๒ ยุ. จริยํ ฯ  
