<span class="LineNumber"> 001 </span>	กิเลสา ฌาปิตา มยฺหํ        ภวา สพฺเพ สมูหตา  
<span class="LineNumber"> 002 </span>	นาโคว พนฺธนํ เฉตฺวา       วิหรามิ อนาสโว ฯ  
<span class="LineNumber"> 003 </span>	สฺวาคตํ วต เม อาสิ        มม พุทฺธสฺส สนฺติเก  
<span class="LineNumber"> 004 </span>	ติสฺโส วิชฺชา อนุปฺปตฺตา      กตํ พุทฺธสฺส สาสนํ  
<span class="LineNumber"> 005 </span>	ปฏิสมฺภิทา จตสฺโส          วิโมกฺขาปิจ อฏฺิเม  
<span class="LineNumber"> 006 </span>	ฉฬภิฺา สจฺฉิกตา          กตํ พุทฺธสฺส สาสนนฺติ ฯ  
<span class="LineNumber"> 007 </span>  อิตฺถํ สุทํ อายสฺมา นฬกุฏิกทายโก เถโร อิมา คาถาโย อภาสิตฺถาติ ฯ  
<span class="LineNumber"> 008 </span>		นฬกุฏิกทายกตฺเถรสฺส อปทานํ สมตฺตํ ฯ  
<span class="LineNumber"> 009 </span>		ทสมํ ปิยาลผลทายกตฺเถราปทานํ (๕๐๐)  
<span class="LineNumber"> 010 </span>	[๙๐] มิคลุทฺโธ ปุเร อาสึ         วิวเน ๑ วิจรํ ตทา  
<span class="LineNumber"> 011 </span>	อทฺทสํ วิรชํ พุทฺธํ           สพฺพธมฺมาน ปารคุํ ฯ  
<span class="LineNumber"> 012 </span>	ปิยาลผลมาทาย            พุทฺธเสฏฺสฺสทาสหํ  
<span class="LineNumber"> 013 </span>	ปุฺเขตฺตสฺส วีรสฺส         ปสนฺโน เสหิ ปาณิภิ ฯ  
<span class="LineNumber"> 014 </span>	เอกตฺตึเส อิโต กปฺเป       ยํ ผลํ อททึ ตทา  
<span class="LineNumber"> 015 </span>	ทุคฺคตึ นาภิชานามิ          ผลทานสฺสิทํ ผลํ ฯ  
<span class="LineNumber"> 016 </span>	กิเลสา ฌาปิตา มยฺหํ        ภวา สพฺเพ สมูหตา  
<span class="LineNumber"> 017 </span>	นาโคว พนฺธนํ เฉตฺวา       วิหรามิ อนาสโว ฯ  
<span class="LineNumber"> 018 </span>	สฺวาคตํ วต เม อาสิ        มม พุทฺธสฺส สนฺติเก  
<span class="LineNumber"> 019 </span>	ติสฺโส วิชฺชา อนุปฺปตฺตา      กตํ พุทฺธสฺส สาสนํ ฯ  
<span class="LineNumber"> 020 </span>#๑ ยุ. วิจิเน ฯ อิโต ปรํ อีทิสเมว ฯ  
