<span class="LineNumber"> 001 </span>	เทวโลเก มนุสฺเส วา       ชาโต วา ยตฺถ กตฺถจิ  
<span class="LineNumber"> 002 </span>	ภเว สุวณฺณวณฺโณ จ         อุตฺตตฺตกนกูปโม ฯ  
<span class="LineNumber"> 003 </span>	มุทุ ๑ มทฺทวา สินิทฺธา      สุขุมา สุกุมาริกา  
<span class="LineNumber"> 004 </span>	ฉวิ เม สพฺพทา โหติ        โพธิปตฺเต สุฉฑฺฑิเต ฯ  
<span class="LineNumber"> 005 </span>	ยโต กุโตจิ คตีสุ           สรีเร สมุทาคเต  
<span class="LineNumber"> 006 </span>	น ลิมฺปติ รโชชลฺลํ          วิปาโก ปตฺตฉฑฺฑิเต ฯ  
<span class="LineNumber"> 007 </span>	อุเณฺห วาตาตเป ตสฺส       อคฺคิตาเปน วา ปน ๒  
<span class="LineNumber"> 008 </span>	คตฺเต เสทา น มุฺจนฺติ      วิปาโก ปตฺตฉฑฺฑิเต ฯ  
<span class="LineNumber"> 009 </span>	กุฏฺํ คณฺโฑ กิลาโส จ       ติลกา ปิฬกา ตถา  
<span class="LineNumber"> 010 </span>	น โหนฺติ กาเย ททฺทุ จ      วิปาโก ปตฺตฉฑฺฑิเต ฯ  
<span class="LineNumber"> 011 </span>	อปรมฺปิ คุณนฺตสฺส           นิพฺพตฺตติ ภวาภเว  
<span class="LineNumber"> 012 </span>	โรคา น โหนฺติ กายสฺมึ      วิปาโก ปตฺตฉฑฺฑิเต ฯ  
<span class="LineNumber"> 013 </span>	อปรมฺปิ คุณนฺตสฺส           นิพฺพตฺตติ ภวาภเว  
<span class="LineNumber"> 014 </span>	น โหนฺติ จิตฺตชา ปีฬา       วิปาโก ปตฺตฉฑฺฑิเต ฯ  
<span class="LineNumber"> 015 </span>	อปรมฺปิ คุณนฺตสฺส           นิพฺพตฺตติ ภวาภเว  
<span class="LineNumber"> 016 </span>	อมิตฺตา น ภวนฺตสฺส         วิปาโก ปตฺตฉฑฺฑิเต ฯ  
<span class="LineNumber"> 017 </span>	อปรมฺปิ คุณนฺตสฺส           นิพฺพตฺตติ ภวาภเว  
<span class="LineNumber"> 018 </span>	อนูนโภโค ภวติ            วิปาโก ปตฺตฉฑฺฑิเต ฯ  
<span class="LineNumber"> 019 </span>	อปรมฺปิ คุณนฺตสฺส           นิพฺพตฺตติ ภวาภเว  
<span class="LineNumber"> 020 </span>	อคฺคิราชูหิ โจเรหิ          น โหติ อุทกา ๓ ภยํ ฯ  
<span class="LineNumber"> 021 </span>#๑ ม. ยุ. มุทุกา ... ฯ ๒ ยุ. ปุน ฯ ๓ ม. ยุ. อุทเก ฯ  
