<span class="LineNumber"> 001 </span>	วิชยีว มหาโยโธ           มารเสนาปฺปมทฺทโน ๑  
<span class="LineNumber"> 002 </span>	จกฺกวตฺตีว โส ราชา        โพชฺฌงฺครตนิสฺสโร ฯ  
<span class="LineNumber"> 003 </span>	มหาภิสกฺกสงฺกาโส          โทสพฺยาธิติกิจฺฉโก  
<span class="LineNumber"> 004 </span>	สลฺลกตฺโต ยถา เสฏฺโ ๒   ทิฏฺิคณฺฑวิผาลโก ฯ  
<span class="LineNumber"> 005 </span>	โส ตทา โลกปชฺโชโต       สนรามรสกฺกโต  
<span class="LineNumber"> 006 </span>	ปริสาสุ นราทิจฺโจ          ธมฺมํ เทสยเต ชิโน ฯ  
<span class="LineNumber"> 007 </span>	ทานํ ทตฺวา มหาโภโค       สีเลน สุคตูปโค  
<span class="LineNumber"> 008 </span>	ภาวนาย จ นิพฺพาติ         อิจฺเจวมนุสาสถ ฯ  
<span class="LineNumber"> 009 </span>	เทสนนฺตํ มหสฺสาทํ          อาทิมชฺฌนฺตโสภนํ  
<span class="LineNumber"> 010 </span>	สุณนฺติ ปริสา สพฺพา         อมตํว มหารสํ ฯ  
<span class="LineNumber"> 011 </span>	สุตฺวา สุมธุรํ ธมฺมํ          ปสนฺโน ชินสาสเน  
<span class="LineNumber"> 012 </span>	สุคตํ สรณํ คนฺตฺวา          ยาวชีวํ นมสฺสหํ ฯ  
<span class="LineNumber"> 013 </span>	มุนิโน คนฺธกุฏิยา           อุพฺพฏฺเฏสึ ๓ ตทา มหึ  
<span class="LineNumber"> 014 </span>	จตุชฺชาเตน คนฺเธน         มาเส อฏฺ ทิเน สฺวหํ ฯ  
<span class="LineNumber"> 015 </span>	ปณิธาย สุคนฺธนฺตํ ๔        สรีรสฺส วิคนฺธิโน  
<span class="LineNumber"> 016 </span>	ตทา ชิโน วิยากาสิ         สุคนฺธตนุลาภิตํ ฯ  
<span class="LineNumber"> 017 </span>	โยยํ คนฺธกุฏิภูมึ            คนฺเธน อุพฺพโฏ ๕ สกึ  
<span class="LineNumber"> 018 </span>	เตน กมฺมวิปาเกน          อุปปนฺโน ยหึ ตหึ ฯ  
<span class="LineNumber"> 019 </span>	สุคนฺธเทโห สพฺพตฺถ         ภวิสฺสติ อยํ นโร  
<span class="LineNumber"> 020 </span>	คุณคนฺธายุโต หุตฺวา         นิพฺพายิสฺสตินาสโว ฯ  
<span class="LineNumber"> 021 </span>#๑ ม. มารเสนาวมทฺทโน ฯ ๒ ม. เวชฺโช ฯ ๓ ม. โอปุฺเชสึ ฯ  
<span class="LineNumber"> 022 </span>#ยุ. โอปุฺเฉสิ ฯ ๔ ม. สุคนฺธตฺตํ ฯ ๕ ม. ยุ. คนฺเธโนปุฺชเต ฯ  
