<span class="LineNumber"> 001 </span>	อโหนุกมฺปิกามฺหากํ          สพฺพาสํ วีร โคตมี  
<span class="LineNumber"> 002 </span>	วาสิตา ตาย ๑ ปุฺเหิ     ปตฺตา โน อาสวกฺขยํ ฯ  
<span class="LineNumber"> 003 </span>	กิเลสา ฌาปิตามฺหากํ        ภวา สพฺเพ สมูหตา  
<span class="LineNumber"> 004 </span>	นาคีว พนฺธนํ เฉตฺวา        วิหราม อนาสวา ฯ  
<span class="LineNumber"> 005 </span>	สฺวาคตํ วต โน อาสิ        พุทฺธเสฏฺสฺส สนฺติเก  
<span class="LineNumber"> 006 </span>	ติสฺโส วิชฺชา อนุปฺปตฺตา      กตํ พุทฺธสฺส สาสนํ ฯ  
<span class="LineNumber"> 007 </span>	ปฏิสมฺภิทา จตสฺโส          วิโมกฺขาปิจ อฏฺิเม  
<span class="LineNumber"> 008 </span>	ฉฬภิฺา สจฺฉิกตา          กตํ พุทฺธสฺส สาสนํ ฯ  
<span class="LineNumber"> 009 </span>	อิทฺธิยฺจ ๒ วสี โหม       ทิพฺพาย โสตธาตุยา  
<span class="LineNumber"> 010 </span>	เจโตปริยาณสฺส           วสี โหม มหามุนิ ฯ  
<span class="LineNumber"> 011 </span>	ปุพฺเพนิวาสํ ชานาม         ทิพฺพจกฺขุ วิโสธิตํ  
<span class="LineNumber"> 012 </span>	สพฺพาสวปริกฺขีณา           นตฺถิ ทานิ ปุนพฺภโว ฯ  
<span class="LineNumber"> 013 </span>	อตฺเถ ธมฺเม จ เนรุตฺเต     ปฏิภาเณ จ วิชฺชติ  
<span class="LineNumber"> 014 </span>	าณํ อมฺหํ มหาวีร          อุปฺปนฺนํ ตว สนฺติเก ฯ  
<span class="LineNumber"> 015 </span>	อสฺมาหิ ปริจิณฺโณสิ          เมตฺตจิตฺตาหิ นายก  
<span class="LineNumber"> 016 </span>	อนุชานาหิ สพฺพาโย ๓      นิพฺพานาย มหามุเน ฯ  
<span class="LineNumber"> 017 </span>	นิพฺพายิสฺสาม อิจฺเจวํ        กึ วกฺขามิ วทนฺติโย  
<span class="LineNumber"> 018 </span>	ยสฺส ทานิ จ โว กาลํ       มฺถาติ ชิโนพฺรวิ ฯ  
<span class="LineNumber"> 019 </span>	โคตมิอาทิกา ตาโย         ตทา ภิกฺขุนิโย ชินํ  
<span class="LineNumber"> 020 </span>	วนฺทิตฺวา อาสนา ตมฺหา      วุฏฺาย อคมึสุ ตา ฯ  
<span class="LineNumber"> 021 </span>#๑ ม. ยุ. ตว ฯ ๒ ม. อิทฺธีสุ จ ฯ ๓ ม. สพฺพาสํ ฯ  
