<span class="LineNumber"> 001 </span>	ตทาติมานิโน สกฺยา         น พุทฺธสฺส คุณฺุโน  
<span class="LineNumber"> 002 </span>	ปณมนฺติ น สมฺพุทฺธํ          ชาติถทฺธา อนาทรา ฯ  
<span class="LineNumber"> 003 </span>	เตสํ สงฺกปฺปมฺาย         อากาเส จงฺกมิ ชิโน  
<span class="LineNumber"> 004 </span>	ปชฺชุนฺโน วิย วสฺสิตฺถ        ปชฺชลิตฺถ ยถา สิขี ฯ  
<span class="LineNumber"> 005 </span>	ทสฺเสตฺวา รูปมตุลํ          ปุน อนฺตรธายถ  
<span class="LineNumber"> 006 </span>	เอโกปิ หุตฺวา พหุธา        อโหสิ ปุนเรกโก ฯ  
<span class="LineNumber"> 007 </span>	อนฺธการํ ปกาสฺจ          ทสฺสยิตฺวา อเนกธา  
<span class="LineNumber"> 008 </span>	ปาฏิเหรํ กริตฺวาน          วินยิ าตเก มุนิ ฯ  
<span class="LineNumber"> 009 </span>	จาตุทฺทีโป มหาเมโฆ        ตาวเทว ปวสฺสถ ๑  
<span class="LineNumber"> 010 </span>	ตทา หิ ชาตกํ พุทฺโธ        เวสฺสนฺตรมเทสยิ ฯ  
<span class="LineNumber"> 011 </span>	ตทา เต ขตฺติยา สพฺเพ      นิหนฺตฺวา ชาติชํ มทํ  
<span class="LineNumber"> 012 </span>	อุเปสุํ สรณํ พุทฺธํ           อาห สุทฺโธทโน ตทา ฯ  
<span class="LineNumber"> 013 </span>		   อิทํ ตติยํ ตว ภูริปฺ  
<span class="LineNumber"> 014 </span>		   ปาทานิ วนฺทามิ สมนฺตจกฺขุ  
<span class="LineNumber"> 015 </span>		   ยทา หิ ชาโต ปวี ปกมฺปยิ  
<span class="LineNumber"> 016 </span>		   ยทา จ ตํ นชฺชหิ ชมฺพุฉายา ฯ  
<span class="LineNumber"> 017 </span>	ตทา พุทฺธานุภาวนฺตํ         ทิสฺวา วิมฺหิตมานโส  
<span class="LineNumber"> 018 </span>	ปพฺพชิตฺวาน ตตฺเถว         นิวสึ มาตุปูชโก ฯ  
<span class="LineNumber"> 019 </span>	จนฺทโน เทวปุตฺโต มํ        อุปคนฺตฺวา อปุจฺฉถ ๒  
<span class="LineNumber"> 020 </span>	ภทฺเทกรตฺตสฺส ตทา         สงฺเขปวิตฺถารํ นยํ ฯ  
<span class="LineNumber"> 021 </span>#๑ ยุ. สมฺปวสฺสถ ฯ ๒ ม. อุปคนฺตฺวานุปุจฺฉถ ฯ ยุ. อุปคนฺตฺวานุรฺชถ ฯ  
