<span class="LineNumber"> 001 </span>	อิทฺธีสุ จ วสี โหมิ          ทิพฺพาย โสตธาตุยา  
<span class="LineNumber"> 002 </span>	เจโตปริยาณสฺส           วสี โหมิ มหามุเน ฯ  
<span class="LineNumber"> 003 </span>	ปุพฺเพนิวาสํ ชานามิ         ทิพฺพจกฺขุํ วิโสธิตํ  
<span class="LineNumber"> 004 </span>	สพฺพาสวปริกฺขีณา           นตฺถิ ทานิ ปุนพฺภโว ฯ  
<span class="LineNumber"> 005 </span>	อตฺถธมฺมนิรุตฺตีสุ            ปฏิภาเณ ตเถว จ  
<span class="LineNumber"> 006 </span>	าณํ มม มหาวีร           อุปฺปนฺนํ ตว สนฺติเก ฯ  
<span class="LineNumber"> 007 </span>	กิเลสา ฌาปิตา มยฺหํ        ภวา สพฺเพ สมูหตา  
<span class="LineNumber"> 008 </span>	นาคีว พนฺธนํ เฉตฺวา        วิหรามิ อนาสวา ฯ  
<span class="LineNumber"> 009 </span>	สฺวาคตํ วต เม อาสิ        พุทฺธเสฏฺสฺส สนฺติเก  
<span class="LineNumber"> 010 </span>	ติสฺโส วิชฺชา อนุปฺปตฺตา      กตํ พุทฺธสฺส สาสนํ ฯ  
<span class="LineNumber"> 011 </span>	ปฏิสมฺภิทา จตสฺโส          วิโมกฺขาปิจ อฏฺิเม  
<span class="LineNumber"> 012 </span>	ฉฬภิฺา สจฺฉิกตา          กตํ พุทฺธสฺส สาสนนฺติ ฯ  
<span class="LineNumber"> 013 </span>	อิตฺถํ สุทํ สุกฺกา ภิกฺขุนี อิมา คาถาโย อภาสิตฺถาติ ฯ  
<span class="LineNumber"> 014 </span>		  สุกฺกาเถริยา อปทานํ สมตฺตํ ฯ  
<span class="LineNumber"> 015 </span>		        ปฺจมํ ภาณวารํ  
<span class="LineNumber"> 016 </span>		ฉฏฺํ อภิรูปนนฺทาเถริยาปทานํ (๓๖)  
<span class="LineNumber"> 017 </span>  [๑๗๖] เอกนวุเต อิโต กปฺเป       วิปสฺสี นาม นายโก  
<span class="LineNumber"> 018 </span>	อุปฺปชฺชิ จารุนยโน ๑       สพฺพธมฺเมสุ จกฺขุมา ฯ  
<span class="LineNumber"> 019 </span>	ตทาหํ พนฺธุมติยา           อิทฺเธ ผีเต มหากุเล  
<span class="LineNumber"> 020 </span>#๑ ม. สพฺพตฺถ จารุทสฺสโน ฯ  
