<span class="LineNumber"> 001 </span>	สุขิโต สชฺชิโต หุตฺวา        สํสรนฺโต ภวาภเว  
<span class="LineNumber"> 002 </span>	พาราณสีปุเร รมฺเม         ราชา อาสิ มหีปติ ฯ  
<span class="LineNumber"> 003 </span>	ตทา ตสฺส มเหสีหํ          อิตฺถีคุมฺพสฺส อุตฺตมา  
<span class="LineNumber"> 004 </span>	ตสฺสาปิ ๑ ทุติยิกา อาสึ     ปุพฺพสิเนเหน อุตฺตริ ๒ ฯ  
<span class="LineNumber"> 005 </span>	ปิณฺฑาย วิจรนฺเต โส        อฏฺ ปจฺเจกนายเก  
<span class="LineNumber"> 006 </span>	ทิสฺวา ปมุทิโต หุตฺวา        ทตฺวา ปิณฺฑํ มหารหํ ฯ  
<span class="LineNumber"> 007 </span>	พุทฺเธ ๓ นิมนฺตยิตฺวาน      กตฺวา รตนมณฺฑปํ  
<span class="LineNumber"> 008 </span>	กมฺมาเรหิ กตมฏฺํ ๔       โสวณฺณํ สตหตฺถกํ ๕ ฯ  
<span class="LineNumber"> 009 </span>	สมาเนตฺวาน เต สพฺเพ      เตสํ ทานมทาสิ โส  
<span class="LineNumber"> 010 </span>	เสนาสเน ๖ ปวิฏฺานํ      ปสนฺโน เสหิ ปาณิภิ ฯ  
<span class="LineNumber"> 011 </span>	ตํปิ ทานํ สหาทาสึ          กาสิราเชนหนฺตทา  
<span class="LineNumber"> 012 </span>	ปุนาหํ พาราณสิยํ           ชาตา กาสิกคามเก ฯ  
<span class="LineNumber"> 013 </span>	กุฏุมฺพิกกุเล ผีเต           สุขิโต โส สภาตุโก  
<span class="LineNumber"> 014 </span>	เชฏฺสฺส ภาตุโน ชายา      อโหสึ สุปติพฺพตา ฯ  
<span class="LineNumber"> 015 </span>	ปจฺเจกพุทฺธํ ทิสฺวาน         มม ภตฺตุกนิยโส  
<span class="LineNumber"> 016 </span>	ภาตุ ภตฺตํ ตสฺส ทตฺวา       อาคเต ตมฺหิ ปาวทิ ฯ  
<span class="LineNumber"> 017 </span>	นาภินนฺทิตฺถ โส ทานํ        ตโต ตสฺส อทาสหํ  
<span class="LineNumber"> 018 </span>	พุทฺธานานิย ตํ อนฺนํ         ปุโน ตสฺเสว โส อทา ฯ  
<span class="LineNumber"> 019 </span>	ตํ ทานํ ฉฑฺฑยิตฺวาน         ทุฏฺา พุทฺธสฺสหํ ตทา  
<span class="LineNumber"> 020 </span>	ปตฺตํ กลลปุณฺณนฺตํ           อทาสึ ตสฺส ตาทิโน ฯ  
<span class="LineNumber"> 021 </span>#๑ ม. ยุ. ตสฺสาติ ทยิตา อาสึ ฯ ๒ ม. ภตฺตุโน ฯ ๓ ม. ปุโน ฯ ๔ ม. ยุ.  
<span class="LineNumber"> 022 </span>#กตํ ปตฺตํ ฯ ๕ ม. ยุ. วต ตตฺตกํ ฯ ๖ ม. โสณฺณาสเน ยุ. โสวณฺณาสเน ฯ  
