<span class="LineNumber"> 001 </span>	เยน เวฬุวนํ ทิฏฺํ          นรนนฺทนนนฺทนํ  
<span class="LineNumber"> 002 </span>	สุทิฏฺํ นนฺทนํ เตน          อมรินฺทสุนนฺทนํ ฯ  
<span class="LineNumber"> 003 </span>	วิหาย นนฺทนํ เทวา         โอตริตฺวา มหีตเล ๑  
<span class="LineNumber"> 004 </span>	รมฺมํ เวฬุวนํ ทิสฺวา         น ตปฺปนฺติ สุวิมฺหิตา ฯ  
<span class="LineNumber"> 005 </span>	ราชปุฺเน นิพฺพตฺตํ         พุทฺธปุฺเน ภูสิตํ  
<span class="LineNumber"> 006 </span>	โก วตฺตา ตสฺส นิสฺเสสํ      วนสฺส คุณสฺจยํ ฯ  
<span class="LineNumber"> 007 </span>	ตํ สุตฺวา วนสมิทฺธึ          มม โสตมโนหรํ  
<span class="LineNumber"> 008 </span>	ทฏฺุกามา ตมุยฺยานํ         รฺโ อาโรจยึ ตทา ฯ  
<span class="LineNumber"> 009 </span>	มหตา ปริวาเรน           ตทา มํ ๒ โส มหีปติ  
<span class="LineNumber"> 010 </span>	สมฺเปเสสิ ๓ ตมุยฺยานํ      ทสฺสนาย สมุสฺสุกํ ฯ  
<span class="LineNumber"> 011 </span>	คจฺฉ ปสฺส มหาโภเค        วนํ เนตฺตรสายนํ  
<span class="LineNumber"> 012 </span>	ยํ สทา ภาติ สิริยา         สุคตาภาณุรฺชิตํ ฯ  
<span class="LineNumber"> 013 </span>	ยทา จ ปิณฺฑาย มุนิ         คิริพฺพชปุรุตฺตมํ  
<span class="LineNumber"> 014 </span>	ปวิฏฺโหํ ตทาเยว          วนํ ทฏฺุมุปาคมึ ฯ  
<span class="LineNumber"> 015 </span>	ตทา ตํ สมฺผุลฺลวนํ ๔       นานาภมรกุชฺชิตํ  
<span class="LineNumber"> 016 </span>	โกกิลาคีตสหิตํ             มยูรคณนจฺจิตํ ฯ  
<span class="LineNumber"> 017 </span>	อปฺปสทฺทมนากิณฺณํ           นานาจงฺกมภูสิตํ  
<span class="LineNumber"> 018 </span>	กุฏิมณฺฑปสงฺกิณฺณํ            โยคีวิรวิราชิตํ ๕ ฯ  
<span class="LineNumber"> 019 </span>	วิจรนฺตี อมฺิสฺสํ           สผลํ นยนํ มมํ  
<span class="LineNumber"> 020 </span>	ตทาปิ ตรุณํ ภิกฺขุํ           ยุตฺตํ ทิสฺวา วิจินฺตยึ ฯ  
<span class="LineNumber"> 021 </span>#๑ ม. มหีตลํ ฯ ๒ ม. จ ฯ ๓ ม. มํ เปเสสิ ฯ ยุ. สมฺปาเปสิ ฯK  
<span class="LineNumber"> 022 </span>#๔ ม. ผุลฺลวิปิมํ ฯ ยุ. ผุลฺลปวนํ ฯ ๕ ม. ยุ. โยคีวรวิราชิตํ ฯ  
