<span class="LineNumber"> 001 </span>	เอกนวุเต อิโต กปฺเป       วิปสฺสี นาม นายโก  
<span class="LineNumber"> 002 </span>	อุปฺปชฺชิ จารุนยโน          สพฺพธมฺเมสุ จกฺขุมา ฯ  
<span class="LineNumber"> 003 </span>	เสฏฺิธีตา ตทา หุตฺวา       พาราณสิปุรุตฺตเม  
<span class="LineNumber"> 004 </span>	นิมนฺเตตฺวาน สมฺพุทฺธํ        สสงฺฆํ โลกนายกํ ฯ  
<span class="LineNumber"> 005 </span>	มหาทานํ ททิตฺวาน          อุปฺปเลหิ วินายกํ  
<span class="LineNumber"> 006 </span>	ปูชยิตฺวา จ เตเหว         วณฺณโสภํ อปตฺถยึ ฯ  
<span class="LineNumber"> 007 </span>	อิมมฺหิ ภทฺทเก กปฺเป        พฺรหฺมพนฺธุ มหายโส  
<span class="LineNumber"> 008 </span>	กสฺสโป นาม นาเมน        อุปฺปชฺชิ วทตํ วโร ฯ  
<span class="LineNumber"> 009 </span>	อุปฏฺาโก มเหสิสฺส         ตทา อาสิ นริสฺสโร  
<span class="LineNumber"> 010 </span>	กาสิราชา กิกี นาม         พาราณสิปุรุตฺตเม ฯ  
<span class="LineNumber"> 011 </span>	ตสฺสาสึ ทุติยา ธีตา         สมณีคุตฺตสวฺหยา  
<span class="LineNumber"> 012 </span>	ธมฺมํ สุตฺวา ชินคฺคสฺส        ปพฺพชฺชํ สมโรจยึ ฯ  
<span class="LineNumber"> 013 </span>	อนุชานิ น โน ตาโต        อคาเรว ตทา มยํ  
<span class="LineNumber"> 014 </span>	วีสํ วสฺสสหสฺสานิ           วิจริมฺห อตนฺทิตา ฯ  
<span class="LineNumber"> 015 </span>	โกมาริพฺรหฺมจริยํ           ราชกฺา สุเขฏฺิตา  
<span class="LineNumber"> 016 </span>	พุทฺโธปฏฺานนิรตา          มุทิตา สตฺต ธีตโร ฯ  
<span class="LineNumber"> 017 </span>	สมณี สมณคุตฺตา จ          ภิกฺขุนี ภิกฺขุทาสิกา  
<span class="LineNumber"> 018 </span>	ธมฺมา เจว สุธมฺมา จ       สตฺตมี สงฺฆทาสิกา ฯ  
<span class="LineNumber"> 019 </span>	อหํ เขมา จ สปฺปฺา       ปฏาจารา จ กุณฺฑลา  
<span class="LineNumber"> 020 </span>	กิสาโคตมี ธมฺมทินฺนา        วิสาขา โหติ สตฺตมี ฯ  
