<span class="LineNumber"> 001 </span>		  จตุตฺถํ สกุลาเถริยาปทานํ (๒๔)  
<span class="LineNumber"> 002 </span>  [๑๖๔] ปทุมุตฺตโร นาม ชิโน        สพฺพธมฺมาน ปารคู  
<span class="LineNumber"> 003 </span>	อิโต สตสหสฺสมฺหิ           กปฺเป อุปฺปชฺชิ นายโก ฯ  
<span class="LineNumber"> 004 </span>	หิตาย สพฺพสตฺตานํ          สุขาย วทตํ วโร  
<span class="LineNumber"> 005 </span>	อตฺถาย ปุริสาชฺโ         ปฏิปนฺโน สเทวเก ฯ  
<span class="LineNumber"> 006 </span>	ยสคฺคปฺปตฺโต สิริมา         กิตฺติวณฺณภโต ๑ ชิโน  
<span class="LineNumber"> 007 </span>	ปูชิโต ๒ สพฺพโลกสฺส       ทิสา สพฺพา สุวิสฺสุโต ฯ  
<span class="LineNumber"> 008 </span>	อุตฺติณฺณวิจิกิจฺโฉ โส         วีติวตฺตกถํกโถ  
<span class="LineNumber"> 009 </span>	สมฺปุณฺณมนสงฺกปฺโป          ปตฺโต สมฺโพธิมุตฺตมํ ฯ  
<span class="LineNumber"> 010 </span>	อนุปฺปนฺนสฺส มคฺคสฺส         อุปฺปาเทตา นรุตฺตโม  
<span class="LineNumber"> 011 </span>	อนกฺขาตฺจ อกฺขาสิ         อสฺชาตฺจ สฺชนี ฯ  
<span class="LineNumber"> 012 </span>	มคฺคฺู จ มคฺควิทู          มคฺคกฺขายี นราสโภ  
<span class="LineNumber"> 013 </span>	มคฺคสฺส กุสโล สตฺถา        สารถีนํ วรุตฺตโม ฯ  
<span class="LineNumber"> 014 </span>	มหาการุณิโก นาโถ ๓      ธมฺมํ เทเสติ นายโก  
<span class="LineNumber"> 015 </span>	นิมุคฺเค กามปงฺกมฺหิ ๔      สมุทฺธรติ ปาณิโน ฯ  
<span class="LineNumber"> 016 </span>	ตทาหํ หํสวติยํ             ชาตา ขตฺติยนนฺทนา  
<span class="LineNumber"> 017 </span>	สุรูปา สธนา จาปิ ๕       ทยิตา จ ๖ สิรีมตี ฯ  
<span class="LineNumber"> 018 </span>	อานนฺทสฺส มหารฺโ        ธีตา ปรมโสภนา  
<span class="LineNumber"> 019 </span>	เวมาตา ภคินี จาปิ         ปทุมุตฺตรนามิโน ฯ  
<span class="LineNumber"> 020 </span>#๑ ม. ยุ. กิตฺติวณฺณคโต ฯ ๒ ยุ. ชิโน สพฺพสฺส โลกสฺส ฯ ๓ ม. ยุ. สตฺถา ฯ  
<span class="LineNumber"> 021 </span>#๔ ยุ. โมหปงฺกมฺหิ ฯ ๕ ยุ. สธนา าสึ ฯ ๖ ยุ. ว ฯ  
