<span class="LineNumber"> 001 </span>	อนุมคฺเคน สมฺพุทฺโธ         ยํ ธมฺมํ อภินีหริ  
<span class="LineNumber"> 002 </span>	อนุโภตฺวา สุขทุกฺขํ          ปตฺโต โพธึ มหามุนิ ฯ  
<span class="LineNumber"> 003 </span>	พฺรหฺมเทวฺจ สมฺพุทฺธํ        โคตมํ โลกนายกํ  
<span class="LineNumber"> 004 </span>	อฺเสํ โลกนาถานํ         สงฺคมนฺเต พหุํ มยา ฯ  
<span class="LineNumber"> 005 </span>	อธิการํ พหุํ มยฺหํ           ตุยฺหตฺถาย มหามุนิ  
<span class="LineNumber"> 006 </span>	คเวสนฺตี ๑ พุทฺธธมฺมํ       อหนฺเต ปริจาริกา ฯ  
<span class="LineNumber"> 007 </span>	กปฺปสตสหสฺเส จ           จตุโร จ อสงฺขเย  
<span class="LineNumber"> 008 </span>	ทีปงฺกโร มหาวีโร          อุปฺปชฺชิ โลกนายโก ฯ  
<span class="LineNumber"> 009 </span>	ปจฺจนฺตเทสวิสเย           นิมนฺเตตฺวา ตถาคตํ  
<span class="LineNumber"> 010 </span>	ตสฺส อาคมนํ มคฺคํ          โสเธนฺติ ตุฏฺมานสา ฯ%                       
<span class="LineNumber"> 011 </span>	เตน กาเลน โส อาสิ       สุเมโธ นาม พฺราหฺมโณ  
<span class="LineNumber"> 012 </span>	มคฺคฺจ ปฏิยาเทสิ          อายโต สพฺพทสฺสิโน ฯ  
<span class="LineNumber"> 013 </span>	เตน กาเลนหํ อาสึ         กฺา พฺราหฺมณสมฺภวา  
<span class="LineNumber"> 014 </span>	สุมิตฺตา นาม นาเมน        อุปคฺฉึ สมาคมํ ฯ  
<span class="LineNumber"> 015 </span>	อฏฺ อุปฺปลหตฺถานิ          ปูชนตฺถาย สตฺถุโน  
<span class="LineNumber"> 016 </span>	อาทาย ชนสฺส มชฺเฌ        อทฺทสํ อิสิมุตฺตมํ ๒ ฯ  
<span class="LineNumber"> 017 </span>	จิรานุคตํ ทยิตํ ๓          อติกฺกนฺตํ ๔ มโนหรํ  
<span class="LineNumber"> 018 </span>	ทิสฺวา ตทา อมฺิสฺสํ        สผลํ ชีวิตํ มม ฯ  
<span class="LineNumber"> 019 </span>	ปรกฺกมนฺตํ สผลํ            อทฺทสํ อิสิโน ตทา  
<span class="LineNumber"> 020 </span>	ปุพฺพกมฺเมน สมฺพุทฺเธ        จิตฺตฺจาปิ ปสีทิ เม ฯ  
<span class="LineNumber"> 021 </span>#๑ ม. คเวสโต ฯ ยุ. คเวสนฺตา ฯ ๒ ม. ยุ. อิสิมุคฺคตํ ฯ ๓ ยุ. ทสฺสิตํ ฯ ๔ ยุ.  
<span class="LineNumber"> 022 </span>#ปฏิกฺกนฺตํ ฯ  
