<span class="LineNumber"> 001 </span>	ตสฺสาสึ ตติยา ธีตา         ภิกฺขุนี อิติ วิสฺสุตา  
<span class="LineNumber"> 002 </span>	ธมฺมํ สุตฺวา ชินคฺคสฺส        ปพฺพชฺชํ สมโรจยึ ฯ  
<span class="LineNumber"> 003 </span>	อนุชานิ น โน ตาโต        อคาเรว ตทา มยํ  
<span class="LineNumber"> 004 </span>	วีสํ วสฺสสหสฺสานิ           วิจริมฺห อตนฺทิตา ฯ  
<span class="LineNumber"> 005 </span>	โกมาริพฺรหฺมจริยํ           ราชกฺา สุเขฏฺิตา ๑  
<span class="LineNumber"> 006 </span>	พุทฺโธปฏฺานนิรตา          มุทิตา สตฺต ธีตโร ฯ  
<span class="LineNumber"> 007 </span>	สมณี สมณคุตฺตา จ          ภิกฺขุนี ภิกฺขุทาสิกา  
<span class="LineNumber"> 008 </span>	ธมฺมา เจว สุธมฺมา จ       สตฺตมี สงฺฆทาสิกา ฯ  
<span class="LineNumber"> 009 </span>	อหํ อุปฺปลวณฺณา จ          เขมา ภทฺทา จ ภิกฺขุนี  
<span class="LineNumber"> 010 </span>	กิสาโคตมี ธมฺมทินฺนา        วิสาขา โหติ สตฺตมี ฯ  
<span class="LineNumber"> 011 </span>	เตหิ กมฺเมหิ สุกเตหิ        เจตนาปณิธีหิ จ  
<span class="LineNumber"> 012 </span>	ชหิตฺวา มานุสํ เทหํ         ตาวตึสํ อคฺฉหํ ๒ ฯ  
<span class="LineNumber"> 013 </span>	ปจฺฉิเม จ ภเว ทานิ        ชาตา เสฏฺิกุเล อหํ  
<span class="LineNumber"> 014 </span>	สาวตฺถิยํ ปุรวเร           อิทฺเธ ผีเต มหทฺธเน ฯ  
<span class="LineNumber"> 015 </span>	ยทา จ โยพฺพนูเปตา        วิตกฺกวสคา อหํ  
<span class="LineNumber"> 016 </span>	นรฺชานปทํ ๓ ทิสฺวา       เตน สทฺธึ อคฺฉหํ ฯ  
<span class="LineNumber"> 017 </span>	เอกปุตฺตปฺปสุตาหํ           ทุติโย กุจฺฉิยา มม  
<span class="LineNumber"> 018 </span>	ตทาหํ มาตาปิตโร          อิกฺขามีติ ๔ สุนิจฺฉิตา ฯ  
<span class="LineNumber"> 019 </span>	นาโรเจสึ ปตึ มยฺหํ         ตทา ตมฺหิ ปวาสิเต  
<span class="LineNumber"> 020 </span>	เอกิกา นิคฺคตา เคหา       คนฺตุํ สาวตฺถิมุตฺตมํ ฯ  
<span class="LineNumber"> 021 </span>#๑ ม. สพฺพตฺถ สุเขธิตา ฯ ๒ ม. สพฺพตฺถ อคจฺฉหํ ฯ ยุ. อคมฺหเส ฯ  
<span class="LineNumber"> 022 </span>#๓ ม. นรฺชารปตึ ฯ ๔ ม. ยุ. โอกฺกามีติ ฯ  
