<span class="LineNumber"> 001 </span>	เอวาหํ จินฺตยิตฺวาน         เนกโกฏิสตํ ธนํ  
<span class="LineNumber"> 002 </span>	นาถานาถานํ ทตฺวาน        หิมวนฺตํ อุปาคมึ ฯ  
<span class="LineNumber"> 003 </span>	หิมวนฺตสฺสาวิทูเร           ธมฺมิโก นาม ปพฺพโต  
<span class="LineNumber"> 004 </span>	อสฺสโม สุกโต มยฺหํ         ปณฺณสาลา สุมาปิตา ฯ  
<span class="LineNumber"> 005 </span>	จงฺกมํ ตตฺถ มาเปสึ         ปฺจโทสวิวชฺชิตํ  
<span class="LineNumber"> 006 </span>	อฏฺคุณสมุเปตํ             อภิฺาพลมาหรึ ฯ  
<span class="LineNumber"> 007 </span>	สาฏกํ ปชหึ ตตฺถ           นวโทสมุปาคตํ  
<span class="LineNumber"> 008 </span>	วากจีรํ นิวาเสสึ           ทฺวาทสคุณมุปาคตํ ฯ  
<span class="LineNumber"> 009 </span>	อฏฺโทสสมากิณฺณํ           ปชหึ ปณฺณสาลกํ  
<span class="LineNumber"> 010 </span>	อุปาคมึ รุกฺขมูลํ            คุเณหิ ๑ ทสหุปาคตํ ฯ  
<span class="LineNumber"> 011 </span>	วาปิตํ โรปิตํ ธฺํ          ปชหึ นิรวเสสโต  
<span class="LineNumber"> 012 </span>	อเนกคุณสมฺปนฺนํ            ปวตฺตผลมาทยึ ฯ  
<span class="LineNumber"> 013 </span>	ตตฺถปฺปธานํ ปทหึ           นิสชฺชฏฺานจงฺกเม  
<span class="LineNumber"> 014 </span>	อพฺภนฺตรมฺหิ สตฺตาเห        อภิฺาพลปาปุณึ ฯ  
<span class="LineNumber"> 015 </span>	เอวํ เม สิทฺธิปตฺตสฺส        วสีภูตสฺส สาสเน  
<span class="LineNumber"> 016 </span>	ทีปงฺกโร นาม ชิโน         อุปฺปชฺชิ โลกนายโก ฯ  
<span class="LineNumber"> 017 </span>	อุปฺปชฺชนฺเต จ ชายนฺเต      พุชฺฌนฺเต ธมฺมเทสเน  
<span class="LineNumber"> 018 </span>	จตุโร นิมิตฺเต นาทฺทสํ       ฌานรติสมปฺปิโต ฯ  
<span class="LineNumber"> 019 </span>	ปจฺจนฺตเทสวิสเย           นิมนฺเตตฺวา ตถาคตํ  
<span class="LineNumber"> 020 </span>	ตสฺส อาคมนํ มคฺคํ          โสเธนฺติ ตุฏฺมานสา ฯ  
<span class="LineNumber"> 021 </span>#๑ ม. ยุ. คุเณ ฯ  
