<span class="LineNumber"> 001 </span>	สาธูติ เต ปฏิสฺสุตฺวา        นิปกา สํวุตินฺทฺริยา  
<span class="LineNumber"> 002 </span>	ปตฺตจีวรมาทาย            ตรมานา อุปาคมม ฯ  
<span class="LineNumber"> 003 </span>	ขีณาสเวหิ วิมเลหิ          ทนฺเตหิ อุตฺตเม ทเม  
<span class="LineNumber"> 004 </span>	สารีปุตฺโต มหาปฺโ        อิทฺธิยา อุปสงฺกมิ ฯ  
<span class="LineNumber"> 005 </span>	เตหิ ภิกฺขูหิ ปริวุโต         สารีปุตฺโต มหาคณี  
<span class="LineNumber"> 006 </span>	ลิฬนฺโต ๑ เทโวว คคเน    อิทฺธิยา อุปสงฺกมิ ฯ  
<span class="LineNumber"> 007 </span>	อุกฺกาสิตฺจ ขิปิตฺจ         อชฺฌุเปกฺขิตฺวาน สุพฺพตา  
<span class="LineNumber"> 008 </span>	สคารวา สปฺปติสฺสา         สมฺพุทฺธํ อุปสงฺกมม ฯ  
<span class="LineNumber"> 009 </span>	อุปสงฺกมิตฺวา ปสฺสนฺติ        สยมฺภุํ โลกนายกํ  
<span class="LineNumber"> 010 </span>	นเภ อจฺจุคฺคตํ วีรํ          จนฺทํว คคเน ยถา ฯ  
<span class="LineNumber"> 011 </span>	ชลนฺตํ ทีปรุกฺขํว            วิชฺชุว คคเน ยถา  
<span class="LineNumber"> 012 </span>	มชฺฌนฺติเกว สุริยํ           ปสฺสนฺติ โลกนายกํ ฯ  
<span class="LineNumber"> 013 </span>	ปฺจภิกฺขุสตา สพฺเพ         ปสฺสนฺติ โลกนายกํ  
<span class="LineNumber"> 014 </span>	รหทมิว วิปฺปสนฺนํ           สุผุลฺลํ ปทุมํ ยถา ฯ  
<span class="LineNumber"> 015 </span>	อฺชลึ ปคฺคเหตฺวาน         ตุฏฺหฏฺา ปโมทิตา  
<span class="LineNumber"> 016 </span>	นมสฺสมานา นิปตนฺติ         สตฺถุโน จกฺกลกฺขเณ ฯ  
<span class="LineNumber"> 017 </span>	สารีปุตฺโต มหาปฺโ        โกรณฺฑสมสาทิโส  
<span class="LineNumber"> 018 </span>	สมาธิชฺฌานกุสโล           วนฺทติ โลกนายกํ ฯ  
<span class="LineNumber"> 019 </span>	คชฺชิโต กาลเมโฆว         นีลุปฺปลสมสาทิโส  
<span class="LineNumber"> 020 </span>	อิทฺธิพเลน อสโม           โมคฺคลฺลาโน มหิทฺธิโก ฯ  
<span class="LineNumber"> 021 </span>#๑ ม. ยุ. ลฬนฺโต ฯ  
