<span class="LineNumber"> 001 </span>	ปจฺจุคฺคมนา วตฺตนฺติ         วชฺชนฺติ เภริโย พหู  
<span class="LineNumber"> 002 </span>	อาโมทิตา นรมรู           สาธุการํ ปวตฺตยุํ ฯ  
<span class="LineNumber"> 003 </span>	เทวา มนุสฺเส ปสฺสนฺติ       มนุสฺสา ๑ ปสฺสนฺติ เทวตา  
<span class="LineNumber"> 004 </span>	อุโภปิ เต ปฺชลิกา         อนุยนฺติ ตถาคตํ ฯ  
<span class="LineNumber"> 005 </span>	เทวา ทิพฺเพหิ ตุริเยหิ       มนุสฺสา มานุสเกหิ ๒ จ  
<span class="LineNumber"> 006 </span>	อุโภปิ เต วชฺชยนฺตา        อนุยนฺติ ตถาคตํ ฯ  
<span class="LineNumber"> 007 </span>	ทิพฺพํ มนฺทารวํ ปุปฺผํ         ปทุมํ ปาริฉตฺตกํ  
<span class="LineNumber"> 008 </span>	ทิโสทิสํ โอกิรนฺติ ๓        อากาเส นภคา ๔ มรู ฯ  
<span class="LineNumber"> 009 </span>	ทิพฺพํ จนฺทนจุณฺณฺจ          วรคนฺธฺจ เกวลํ  
<span class="LineNumber"> 010 </span>	ทิโสทิสํ โอกิรนฺติ ๓        อากาเส นภคา ๔ มรู ฯ  
<span class="LineNumber"> 011 </span>	จมฺปกํ สลฬํ นีปํ            นาคปุนฺนาคเกตกํ  
<span class="LineNumber"> 012 </span>	ทีโสทิสํ โอกิรนฺติ ๓        ภูมิตลคตา นรา ฯ  
<span class="LineNumber"> 013 </span>	เกเส มุฺจิตฺวาหํ ตตฺถ       วากจีรํ จ จมฺมกํ  
<span class="LineNumber"> 014 </span>	กลเล ปตฺถริตฺวาน          อวกุชฺโช นิปชฺชหํ ฯ  
<span class="LineNumber"> 015 </span>	อกฺกมิตฺวาน มํ พุทฺโธ        สห สิสฺเสหิ คจฺฉตุ  
<span class="LineNumber"> 016 </span>	มา นํ กลลํ ๕ อกฺกมิตฺถ     หิตาย เม ภวิสฺสติ ฯ  
<span class="LineNumber"> 017 </span>	ปวิยํ นิปนฺนสฺส            เอวํ เม อาสิ เจตโส  
<span class="LineNumber"> 018 </span>	อิจฺฉมาโน อหํ อชฺช         กิเลเส ฌาปเย มม ฯ  
<span class="LineNumber"> 019 </span>	กึ เม อฺาตเวเสน        ธมฺมํ สจฺฉิกเตนิธ  
<span class="LineNumber"> 020 </span>	สพฺพฺุตํ ปาปุณิตฺวา         มุตฺโต ๖ โมเจ สเทวเก ฯ  
<span class="LineNumber"> 021 </span>#๑ ม. ยุ. มนุสฺสาปิ จ เทวตา ฯ ๒ ม. มานุเสหิ จ ฯ ๓ ม. ยุ. อุกฺขิปนฺติ ฯ  
<span class="LineNumber"> 022 </span>#๔ ม. อากาสนภคตา ฯ ๕ ม. ยุ. กลเล ฯ ๖ ม. ยุ. พุทฺโธ เหสฺสํ ... ฯ  
