<span class="LineNumber"> 001 </span>	วสฺสสตสหสฺสานิ             อายุ วิชฺชติ ตาวเท  
<span class="LineNumber"> 002 </span>	ตาวตา ติฏฺมาโน โส        ตาเรสิ ชนตํ พหุํ ฯ  
<span class="LineNumber"> 003 </span>	ขีณาสเวหิ วิมเลหิ           วิจิตฺตา อาสิ เมทนี  
<span class="LineNumber"> 004 </span>	ยถา คคนํ อุฬุภิ             เอวํ โส อุปโสภถ ฯ  
<span class="LineNumber"> 005 </span>	เตปิ นาคา อปฺปเมยฺยา       อสงฺโขพฺภา ๑ ทุราสทา  
<span class="LineNumber"> 006 </span>	วิชฺชุปาตํว ทสฺเสตฺวา         นิพฺพุตา เต มหายสา ฯ  
<span class="LineNumber"> 007 </span>	สา จ อตุลิยา ชินสฺส อิทฺธิ     าณปริภาวิโต สมาธิ  
<span class="LineNumber"> 008 </span>	สพฺพํ สมนฺตรหิตํ             นนุ ริตฺตา สพฺพสงฺขาราติ ฯ  
<span class="LineNumber"> 009 </span>	โกณฺฑฺโ สิริธโร ๒ พุทฺโธ   นนฺทารามมฺหิ นิพฺพุโต  
<span class="LineNumber"> 010 </span>	ตตฺเถว เจติโย ๓ ตสฺส      สตฺตโยชนมุสฺสิโตติ ฯ  
<span class="LineNumber"> 011 </span>		     โกณฺฑฺพุทฺธวํโส ทุติโย ฯ  
<span class="LineNumber"> 012 </span>		      ตติโย มงฺคลพุทฺธวํโส  
<span class="LineNumber"> 013 </span>	[๔] โกณฺฑฺสฺส อปเรน          มงฺคโล นาม นายโก  
<span class="LineNumber"> 014 </span>	ตมํ โลเก นิหนฺตฺวาน         ธมฺโมกฺกมภิธารยิ ฯ  
<span class="LineNumber"> 015 </span>	อตุลาสิ ๔ ปภา ตสฺส        ชิเนหฺเหิ อุตฺตริ ๕  
<span class="LineNumber"> 016 </span>	จนฺทสุริยปฺปภํ หนฺตฺวา         ทสสหสฺสี วิโรจติ ฯ  
<span class="LineNumber"> 017 </span>	โสปิ พุทฺโธ ปกาเสสิ         จตุโร สจฺจวรุตฺตเม  
<span class="LineNumber"> 018 </span>	เต เต สจฺจรสํ ปิตฺวา        วิโนเทนฺติ มหาตมํ ฯ  
<span class="LineNumber"> 019 </span>#๑ ม. ยุ. อสงฺโขภา ฯ ๒ ม. ยุ. ปวโร ฯ ๓ ม. ยุ. จิตฺโต ฯ ๔ ยุ. อตุลาปิ ฯ  
<span class="LineNumber"> 020 </span>#๕ ม. ยุ. อุตฺตรึ ฯ  
