<span class="LineNumber"> 001 </span>	พฺรหฺมุนา ยาจิโต สนฺโต       อโนมทสฺสี มหามุนิ  
<span class="LineNumber"> 002 </span>	วตฺตจกฺโก มหาวีโร          สุทสฺสนุยฺยานมุตฺตเม ฯ  
<span class="LineNumber"> 003 </span>	นิสโภ จ อโนโม จ          อเหสุํ อคฺคสาวกา  
<span class="LineNumber"> 004 </span>	วรุโณ นามุปฏฺาโก          อโนมทสฺสิสฺส สตฺถุโน ฯ  
<span class="LineNumber"> 005 </span>	สุนฺทรา ๑ จ สุมนา จ       อเหสุํ อคฺคสาวิกา  
<span class="LineNumber"> 006 </span>	โพธิ ตสฺส ภควโต           อชฺชุโนติ ปวุจฺจติ ฯ  
<span class="LineNumber"> 007 </span>	นนฺทิวฑฺโฒ สิริวฑฺโฒ          อเหสุํ อคฺคุปฏฺกา  
<span class="LineNumber"> 008 </span>	อุปฺปลา จ ๒ ปทุมา จ       อเหสุํ อคฺคุปฏฺิกา ฯ  
<span class="LineNumber"> 009 </span>	อฏฺปณฺณาสรตนํ             อจฺจุคฺคโต มหามุนิ  
<span class="LineNumber"> 010 </span>	ปภา นิทฺธาวตี ตสฺส          สตรํสีว อุคฺคโต ฯ  
<span class="LineNumber"> 011 </span>	วสฺส สตสหสฺสานิ            อายุ วิชฺชติ ตาวเท  
<span class="LineNumber"> 012 </span>	ตาวตา ติฏฺมาโน โส        ตาเรสิ ชนตํ พหุํ ฯ  
<span class="LineNumber"> 013 </span>	สุปุปฺผิตํ ปาวจนํ             อรหนฺเตหิ ตาทิหิ  
<span class="LineNumber"> 014 </span>	วีตราเคหิ วิมเลหิ           โสภติ ๓ ชินสาสนํ ฯ  
<span class="LineNumber"> 015 </span>	โส จ สตฺถา อมิตยโส        ยุคานิ ตานิ อตุลิยานิ  
<span class="LineNumber"> 016 </span>	สพฺพํ สมนฺตรหิตํ             นนุ ริตฺตา สพฺพสงฺขาราติ ฯ  
<span class="LineNumber"> 017 </span>	อโนมทสฺสี ชิโน สตฺถา        ธมฺมารามมฺหิ นิพฺพุโต  
<span class="LineNumber"> 018 </span>	ตตฺเถว ตสฺส ชินถูโป         อุพฺเพโธ ปน วีสตีติ ฯ  
<span class="LineNumber"> 019 </span>		   อโนมทสฺสิพุทฺธวํโส สตฺตโม ฯ  
<span class="LineNumber"> 020 </span>#๑ โป. สุนฺทรา จ สุนามา จ ฯ ม. ยุ. สุนฺทรี จ ฯ ๒ ม. ยุ. เจว ฯ  
<span class="LineNumber"> 021 </span>#๓ ม. ยุ. โสภิตฺถ ฯ  
