<span class="LineNumber"> 001 </span>	อนาคตมฺหิ อทฺธาเน          เหสฺสาม สมฺมุขา อิมํ ฯ  
<span class="LineNumber"> 002 </span>	ตสฺสาปิ วจนํ สุตฺวา          ภิยฺโย จิตฺตํ ปสาทยึ  
<span class="LineNumber"> 003 </span>	อุตฺตรึ วตฺตมธิฏฺาสึ          ทสปารมิปูริยา ฯ  
<span class="LineNumber"> 004 </span>	สพฺพฺุตํ คเวสนฺโต          ทานํ ทตฺวา นรุตฺตโม ๑  
<span class="LineNumber"> 005 </span>	โอหายาหํ มหารชฺชํ          ปพฺพชึ ชินสนฺติเก ฯ  
<span class="LineNumber"> 006 </span>	นครํ โสภวตี นาม           โสโภ นามาสิ ขตฺติโย  
<span class="LineNumber"> 007 </span>	วสติ ตตฺถ นคเร            สมฺพุทฺธสฺส มหากุลํ ฯ  
<span class="LineNumber"> 008 </span>	พฺราหฺมโณ ยฺทตฺโต จ       อาสิ พุทฺธสฺส โส ปิตา  
<span class="LineNumber"> 009 </span>	อุตฺตรา นาม ชนิกา          โกนาคมนสฺส สตฺถุโน ฯ  
<span class="LineNumber"> 010 </span>	ตีณิ วสฺสสหสฺสานิ            อคารํ อชฺฌาวสิ โส  
<span class="LineNumber"> 011 </span>	ตุสิตสนฺตุสิตสนฺตุฏฺา          ตโย ปาสาทมุตฺตมา ฯ  
<span class="LineNumber"> 012 </span>	อนูนโสฬสสหสฺสานิ           นาริโย สมลงฺกตา  
<span class="LineNumber"> 013 </span>	รุจิคตฺตา นาม นารี          สตฺถวาโห นาม อตฺรโช ฯ  
<span class="LineNumber"> 014 </span>	นิมิตฺเต จตุโร ทิสฺวา         หตฺถิยาเนน นิกฺขมิ  
<span class="LineNumber"> 015 </span>	ฉมาสํ ปธานจารํ            อจริ ปุริสุตฺตโม ฯ  
<span class="LineNumber"> 016 </span>	พฺรหฺมุนา ยาจิโต สนฺโต       โกนาคมโน ๒ โลกนายโก  
<span class="LineNumber"> 017 </span>	วตฺตจกฺโก มหาวีโร          มิคทาเย นรุตฺตโม ฯ  
<span class="LineNumber"> 018 </span>	ภิยฺโยโส ๓ อุตฺตโร นาม     อเหสุํ อคฺคสาวกา  
<span class="LineNumber"> 019 </span>	โสตฺถิโช นามุปฏฺาโก        โกนาคมนสฺส ยสสฺสิโน ๔ ฯ  
<span class="LineNumber"> 020 </span>#๑ ม. ยุ. นรุตฺตเม ฯ ๒ ม. โกนาคมนนายโก ฯ ๓ ม. ภิยฺยโส ฯ ๔ ม. ยุ.  
<span class="LineNumber"> 021 </span>#สตฺถุโน ฯ  
