<span class="LineNumber"> 001 </span>	มมํ อุปทฺทุตํ ทิสฺวา           ยกฺโข มํ อิทมพฺรวิ  
<span class="LineNumber"> 002 </span>	นาเสเหตํ ฉวํ ปาปํ          สงฺเคหิ จ ขุเรหิ จ ฯ  
<span class="LineNumber"> 003 </span>	เอวํ วุตฺเต ตทา ยกฺเข       อหํ ตํ อิทมพฺรวึ  
<span class="LineNumber"> 004 </span>	กึ ตฺวํ มกฺเขสิ กุณเปน        ปาเปน อนริเยน มํ ฯ  
<span class="LineNumber"> 005 </span>	ยทิหนฺตสฺส ปกุปฺเปยฺยํ         ตโต หีนตโร ภเว  
<span class="LineNumber"> 006 </span>	สีลฺจ เม ปภิชฺเชยฺย         วิฺู จ ครเหยฺยุ มํ ฯ  
<span class="LineNumber"> 007 </span>	หิฬิตา ชีวิตา วาปิ           ปริสุทฺเธน มตํ วรํ  
<span class="LineNumber"> 008 </span>	กฺยาหํ ชีวิตเหตูปิ            กาหามิ ปรเหธนํ ฯ  
<span class="LineNumber"> 009 </span>		           [๑]  
<span class="LineNumber"> 010 </span>	หีนมชฺฌิมอุกฺกฏฺเ            สหนฺโต อวมานิตํ  
<span class="LineNumber"> 011 </span>	เอวํ ลภติ สปฺปฺโ          มนสา ยถา ปตฺถิตนฺติ ฯ  
<span class="LineNumber"> 012 </span>		     มหิสราชจริยํ ปฺจมํ ฯ  
<span class="LineNumber"> 013 </span>		        ฉฏฺํ รุรุมิคจริยํ  
<span class="LineNumber"> 014 </span>	[๑๖] ปุนาปรํ ยทา โหมิ           สุตตฺตกนกสนฺนิโภ  
<span class="LineNumber"> 015 </span>	มิคราชา รุรุ นาม           ปรมสีลสมาหิโต ฯ  
<span class="LineNumber"> 016 </span>	รมฺเม ปเทเส รมฺมณีเย       วิวิตฺเต อมนุสฺสเก  
<span class="LineNumber"> 017 </span>	ตตฺถ วาสํ อุปคฺฉึ           คงฺคากูเล มโนรเม ฯ  
<span class="LineNumber"> 018 </span>	อถ อุปริ คงฺคาย            ธนิเกหิ ปริปีฬิโต  
<span class="LineNumber"> 019 </span>	ปุริโส คงฺคาย ปตติ          ชีวามิ วา มรามิ วา ฯ  
<span class="LineNumber"> 020 </span>#๑ ม. ยุ. น เมวายํ มฺมาโน        อฺเเปวํ กริสฺสติ  
<span class="LineNumber"> 021 </span>#       เตว ตสฺส วธิสฺสนฺติ          สา เม มุตฺติ ภวิสฺสติ ฯ  
