<span class="LineNumber"> 001 </span>		    ปณฺณรสมํ มหาโลมหํสจริยํ  
<span class="LineNumber"> 002 </span>	[๓๕] สุสาเน เสยฺยํ กปฺเปมิ        ฉวฏฺิกํ อุปนิธาย ๑  
<span class="LineNumber"> 003 </span>	คามมณฺฑลา อุปาคนฺตฺวา       รูปํ ทสฺเสนฺติ นปฺปกํ ฯ  
<span class="LineNumber"> 004 </span>	อปเร คนฺธฺจ มาลฺจ        โภชนํ วิวิธํ พหุํ  
<span class="LineNumber"> 005 </span>	อุปายนานิ อุปเนนฺติ          หฏฺา สํวิคฺคมานสา ฯ  
<span class="LineNumber"> 006 </span>	เย เม ทุกฺขํ อุปหรนฺติ        เย จ เทนฺติ สุขํ มม  
<span class="LineNumber"> 007 </span>	สพฺเพสํ สมโก โหมิ          ทยา โกโป น วิชฺชติ ฯ  
<span class="LineNumber"> 008 </span>	สุขทุกฺเข ตุลาภูโต           ยเสสุ อยเสสุ จ  
<span class="LineNumber"> 009 </span>	สพฺพตฺถ สมโก โหมิ          เอสา เม อุเปกฺขาปารมีติ ฯ  
<span class="LineNumber"> 010 </span>		     มหาโลมหํสจริยํ ปณฺณรสมํ ฯ  
<span class="LineNumber"> 011 </span>		          ตสฺสุทฺทานํ  
<span class="LineNumber"> 012 </span>	ยุธฺชโย โสมนสฺโส          อโยฆรภิเสน จ  
<span class="LineNumber"> 013 </span>	โสณนนฺโท มูคผกฺโข          กปิราชา สจฺจสวฺหโย ฯ  
<span class="LineNumber"> 014 </span>	วฏฺฏโก มจฺฉราชา จ         กณฺหทีปายโน อิสิ  
<span class="LineNumber"> 015 </span>	สุตโสโม ปุเร ๒ อาสิ       สาโม จ เอกราชา ๓ จ  
<span class="LineNumber"> 016 </span>	อุเปกฺขาปารมี อาสิ          อิติ วุตฺตํ มเหสินา ฯ  
<span class="LineNumber"> 017 </span>	เอวํ พหุวิธํ ทุกฺขํ            สมฺปตฺติฺจ พหูวิธํ  
<span class="LineNumber"> 018 </span>	ภวาภเว อนุภวิตฺวา          ปตฺโต สมฺโพธิมุตฺตมํ ฯ  
<span class="LineNumber"> 019 </span>	ทตฺวา ทาตพฺพกํ ทานํ         สีลํ ปูเรตฺวา อเสสโต  
<span class="LineNumber"> 020 </span>	นิกฺขมฺมปารมึ คนฺตฺวา         ปตฺโต สมฺโพธิมุตฺตมํ ฯ  
<span class="LineNumber"> 021 </span>#๑ ม. อุปนิธายหํ ฯ ยุ. นิธายหํ ฯ ๒ ม. ยุ. ปุน อาสึ ฯ ๓ ม. ยุ. เอกราชหุ ฯ  
