<span class="LineNumber"> 001 </span>					วัตร ๑๘ ข้อ    
<span class="LineNumber"> 002 </span>	[๓๐๙] ดูกรภิกษุทั้งหลาย ภิกษุถูกสงฆ์ลงอุกเขปนียกรรม ฐานไม่สละทิฐิอันเป็นบาป
<span class="LineNumber"> 003 </span>แล้ว ต้องประพฤติโดยชอบ    
<span class="LineNumber"> 004 </span>	วิธีประพฤติชอบในอุกเขปนียกรรม ฐานไม่สละทิฐิอันเป็นบาปนั้นดังต่อไปนี้:-    
<span class="LineNumber"> 005 </span>	๑. ไม่พึงให้อุปสมบท    
<span class="LineNumber"> 006 </span>	๒. ไม่พึงให้นิสัย    
<span class="LineNumber"> 007 </span>	๓. ไม่พึงให้สามเณรอุปัฏฐาก    
<span class="LineNumber"> 008 </span>	๔. ไม่พึงรับสมมติเป็นผู้สั่งสอนภิกษุณี    
<span class="LineNumber"> 009 </span>	๕. แม้ได้รับสมมติแล้ว ก็ไม่พึงสั่งสอนภิกษุณี    
<span class="LineNumber"> 010 </span>	๖. สงฆ์ลงอุกเขปนียกรรม ฐานไม่สละทิฐิอันเป็นบาปเพราะอาบัติใดไม่พึงต้องอาบัตินั้น    
<span class="LineNumber"> 011 </span>	๗. ไม่พึงต้องอาบัติอื่นอันเช่นกัน    
<span class="LineNumber"> 012 </span>	๘. ไม่พึงต้องอาบัติอันเลวทรามกว่านั้น    
<span class="LineNumber"> 013 </span>	๙. ไม่พึงติกรรม    
<span class="LineNumber"> 014 </span>	๑๐. ไม่พึงติภิกษุทั้งหลายผู้ทำกรรม    
<span class="LineNumber"> 015 </span>	๑๑. ไม่พึงห้ามอุโบสถแก่ปกตัตตะภิกษุ    
<span class="LineNumber"> 016 </span>	๑๒. ไม่พึงห้ามปวารณาแก่ปกตัตตะภิกษุ    
<span class="LineNumber"> 017 </span>	๑๓. ไม่พึงทำการไต่สวน    
<span class="LineNumber"> 018 </span>	๑๔. ไม่พึงเริ่มอนุวาทาธิกรณ์    
<span class="LineNumber"> 019 </span>	๑๕. ไม่พึงยังภิกษุอื่นให้ทำโอกาส    
<span class="LineNumber"> 020 </span>	๑๖. ไม่พึงโจทภิกษุอื่น    
<span class="LineNumber"> 021 </span>	๑๗. ไม่พึงให้ภิกษุอื่นให้การ    
<span class="LineNumber"> 022 </span>	๑๘. ไม่พึงช่วยภิกษุกับภิกษุให้สู้อธิกรณ์กัน ฯ    
<span class="LineNumber"> 023 </span>					วัตร ๑๘ ข้อ    
<span class="LineNumber"> 024 </span>			ในอุกเขปนียกรรม ฐานไม่สละทิฐิอันเป็นบาป จบ
